state,period,year,unemployment_rate,qty_unemployed,qty_employed,labour_force
Louisiana,M12,2016,5.4,112436,1971776,2084212
Louisiana,M11,2016,5.4,114387,1990041,2104428
Louisiana,M10,2016,5.9,124482,1993994,2118476
Louisiana,M09,2016,6.4,134882,1984067,2118949
Louisiana,M08,2016,6.5,138745,1980049,2118794
Louisiana,M07,2016,6.6,142515,2009749,2152264
Louisiana,M06,2016,6.9,149501,2005686,2155187
Louisiana,M05,2016,5.9,124825,2001313,2126138
Louisiana,M04,2016,5.7,121287,2005989,2127276
Louisiana,M03,2016,6.0,128087,1999260,2127347
Louisiana,M02,2016,5.8,121977,1988088,2110065
Louisiana,M01,2016,6.4,136134,1975488,2111622
Louisiana,M12,2015,5.4,114227,2005239,2119466
Louisiana,M11,2015,5.7,121158,2021461,2142619
Louisiana,M10,2015,6.0,128275,2026038,2154313
Louisiana,M09,2015,6.1,131565,2011294,2142859
Louisiana,M08,2015,6.4,138667,2019987,2158654
Louisiana,M07,2015,6.7,146356,2044812,2191168
Louisiana,M06,2015,7.0,154559,2042462,2197021
Louisiana,M05,2015,6.4,139660,2036649,2176309
Louisiana,M04,2015,6.0,131017,2038672,2169689
Louisiana,M03,2015,6.4,139127,2025533,2164660
Louisiana,M02,2015,6.5,139221,2014339,2153560
Louisiana,M01,2015,7.3,158665,2003219,2161884
Louisiana,M12,2014,6.4,138042,2032106,2170148
Louisiana,M11,2014,6.7,147902,2047046,2194948
Louisiana,M10,2014,6.8,149338,2049306,2198644
Louisiana,M09,2014,7.0,152332,2027957,2180289
Louisiana,M08,2014,7.3,160337,2023205,2183542
Louisiana,M07,2014,7.2,158408,2038370,2196778
Louisiana,M06,2014,7.0,152910,2027356,2180266
Louisiana,M05,2014,6.0,128987,2009584,2138571
Louisiana,M04,2014,5.1,108507,2006555,2115062
Louisiana,M03,2014,5.6,117808,1992782,2110590
Louisiana,M02,2014,5.3,109622,1971502,2081124
Louisiana,M01,2014,5.8,120784,1955713,2076497
Louisiana,M12,2013,5.0,103557,1979666,2083223
Louisiana,M11,2013,5.4,114295,1994627,2108922
Louisiana,M10,2013,6.1,127991,1982939,2110930
Louisiana,M09,2013,6.4,135116,1975948,2111064
Louisiana,M08,2013,6.9,146431,1970698,2117129
Louisiana,M07,2013,7.3,155985,1986541,2142526
Louisiana,M06,2013,7.9,170435,1977458,2147893
Louisiana,M05,2013,6.9,146049,1962602,2108651
Louisiana,M04,2013,6.5,135631,1961035,2096666
Louisiana,M03,2013,6.8,141315,1943295,2084610
Louisiana,M02,2013,6.9,142397,1930316,2072713
Louisiana,M01,2013,7.9,164162,1912097,2076259
Louisiana,M12,2012,6.4,132086,1946632,2078718
Louisiana,M11,2012,5.9,123151,1962415,2085566
Louisiana,M10,2012,6.4,134352,1964864,2099216
Louisiana,M09,2012,6.6,136952,1942830,2079782
Louisiana,M08,2012,7.3,152848,1933878,2086726
Louisiana,M07,2012,7.8,165191,1952235,2117426
Louisiana,M06,2012,8.2,174431,1948053,2122484
Louisiana,M05,2012,7.2,149403,1934504,2083907
Louisiana,M04,2012,6.6,137354,1930276,2067630
Louisiana,M03,2012,7.2,148384,1912377,2060761
Louisiana,M02,2012,7.3,148491,1893614,2042105
Louisiana,M01,2012,8.0,163071,1875963,2039034
Louisiana,M12,2011,7.0,143146,1911035,2054181
Louisiana,M11,2011,6.9,143762,1927849,2071611
Louisiana,M10,2011,7.5,157272,1928724,2085996
Louisiana,M09,2011,7.7,160580,1916277,2076857
Louisiana,M08,2011,8.1,167588,1913406,2080994
Louisiana,M07,2011,8.2,172725,1929345,2102070
Louisiana,M06,2011,8.7,183107,1918415,2101522
Louisiana,M05,2011,7.7,159854,1911475,2071329
Louisiana,M04,2011,7.4,152520,1915303,2067823
Louisiana,M03,2011,7.8,162062,1902619,2064681
Louisiana,M02,2011,7.9,162334,1886142,2048476
Louisiana,M01,2011,8.8,181406,1871657,2053063
Louisiana,M12,2010,7.9,163148,1904063,2067211
Louisiana,M11,2010,8.1,169430,1920158,2089588
Louisiana,M10,2010,8.1,169437,1930313,2099750
Louisiana,M09,2010,8.2,172831,1922747,2095578
Louisiana,M08,2010,8.7,183080,1927919,2110999
Louisiana,M07,2010,8.4,179468,1949773,2129241
Louisiana,M06,2010,8.6,183943,1944913,2128856
Louisiana,M05,2010,7.6,160108,1933291,2093399
Louisiana,M04,2010,7.1,147906,1938969,2086875
Louisiana,M03,2010,7.3,151114,1906872,2057986
Louisiana,M02,2010,7.2,147204,1887883,2035087
Louisiana,M01,2010,8.2,167016,1871324,2038340
Louisiana,M12,2009,7.0,143321,1897628,2040949
Louisiana,M11,2009,6.7,137760,1925765,2063525
Louisiana,M10,2009,7.0,145588,1922422,2068010
Louisiana,M09,2009,7.1,145735,1909896,2055631
Louisiana,M08,2009,7.4,154621,1921715,2076336
Louisiana,M07,2009,7.5,158405,1947880,2106285
Louisiana,M06,2009,7.8,163364,1936538,2099902
Louisiana,M05,2009,6.5,133213,1925525,2058738
Louisiana,M04,2009,5.8,119192,1933765,2052957
Louisiana,M03,2009,6.2,126794,1921756,2048550
Louisiana,M02,2009,6.1,125231,1924000,2049231
Louisiana,M01,2009,6.7,137386,1919722,2057108
Louisiana,M12,2008,5.5,115151,1972218,2087369
Louisiana,M11,2008,5.3,110727,1997154,2107881
Louisiana,M10,2008,5.4,115326,2007571,2122897
Louisiana,M09,2008,5.7,119344,1980259,2099603
Louisiana,M08,2008,5.5,116018,1994217,2110235
Louisiana,M07,2008,5.2,111073,2013796,2124869
Louisiana,M06,2008,5.4,113951,2001806,2115757
Louisiana,M05,2008,4.3,88866,1982094,2070960
Louisiana,M04,2008,3.6,74672,1985181,2059853
Louisiana,M03,2008,4.2,85823,1965658,2051481
Louisiana,M02,2008,3.9,79791,1950928,2030719
Louisiana,M01,2008,4.8,98708,1937689,2036397
Louisiana,M12,2007,4.1,83876,1969612,2053488
Louisiana,M11,2007,3.7,76362,1985518,2061880
Louisiana,M10,2007,3.8,77329,1975192,2052521
Louisiana,M09,2007,4.1,84469,1952091,2036560
Louisiana,M08,2007,4.4,88981,1946630,2035611
Louisiana,M07,2007,4.7,96975,1968454,2065429
Louisiana,M06,2007,5.1,105625,1956116,2061741
Louisiana,M05,2007,4.2,85567,1929356,2014923
Louisiana,M04,2007,4.0,79295,1925030,2004325
Louisiana,M03,2007,4.1,81352,1926699,2008051
Louisiana,M02,2007,4.0,80070,1905171,1985241
Louisiana,M01,2007,4.9,96848,1888583,1985431
Louisiana,M12,2006,3.9,77493,1927526,2005019
Louisiana,M11,2006,4.1,82294,1930220,2012514
Louisiana,M10,2006,4.0,81550,1932777,2014327
Louisiana,M09,2006,4.2,83838,1904318,1988156
Louisiana,M08,2006,4.5,88878,1908187,1997065
Louisiana,M07,2006,4.5,90534,1923825,2014359
Louisiana,M06,2006,5.1,103508,1916620,2020128
Louisiana,M05,2006,4.3,85631,1892624,1978255
Louisiana,M04,2006,4.1,79737,1888195,1967932
Louisiana,M03,2006,4.3,83509,1877930,1961439
Louisiana,M02,2006,4.5,86875,1858985,1945860
Louisiana,M01,2006,6.1,118541,1838567,1957108
Louisiana,M12,2005,6.7,133451,1871239,2004690
Louisiana,M11,2005,10.3,215876,1875221,2091097
Louisiana,M10,2005,10.6,223440,1880830,2104270
Louisiana,M09,2005,10.9,230825,1881239,2112064
Louisiana,M08,2005,6.1,127666,1958790,2086456
Louisiana,M07,2005,6.2,130711,1982488,2113199
Louisiana,M06,2005,6.6,139547,1969064,2108611
Louisiana,M05,2005,5.6,115392,1953561,2068953
Louisiana,M04,2005,5.1,105883,1952106,2057989
Louisiana,M03,2005,5.4,109878,1925396,2035274
Louisiana,M02,2005,5.7,115257,1910702,2025959
Louisiana,M01,2005,6.3,128284,1895978,2024262
Louisiana,M12,2004,5.5,111896,1931032,2042928
Louisiana,M11,2004,5.5,113520,1943959,2057479
Louisiana,M10,2004,5.6,115020,1940151,2055171
Louisiana,M09,2004,5.7,114564,1912709,2027273
Louisiana,M08,2004,5.9,121753,1925067,2046820
Louisiana,M07,2004,6.4,132249,1946469,2078718
Louisiana,M06,2004,7.0,145833,1928744,2074577
Louisiana,M05,2004,5.9,119570,1908531,2028101
Louisiana,M04,2004,5.5,111256,1910719,2021975
Louisiana,M03,2004,5.9,118089,1896493,2014582
Louisiana,M02,2004,5.6,111051,1886395,1997446
Louisiana,M01,2004,6.6,132879,1868162,2001041
Louisiana,M12,2003,5.4,109197,1898394,2007591
Louisiana,M11,2003,5.6,113686,1909235,2022921
Louisiana,M10,2003,5.8,117083,1906729,2023812
Louisiana,M09,2003,6.3,125315,1877502,2002817
Louisiana,M08,2003,6.9,138970,1882613,2021583
Louisiana,M07,2003,7.2,147269,1903044,2050313
Louisiana,M06,2003,7.9,163785,1901732,2065517
Louisiana,M05,2003,6.5,130791,1887083,2017874
Louisiana,M04,2003,6.1,122223,1893079,2015302
Louisiana,M03,2003,6.3,125545,1880741,2006286
Louisiana,M02,2003,6.1,121270,1873522,1994792
Louisiana,M01,2003,6.9,137064,1854012,1991076
Louisiana,M12,2002,6.0,118776,1877167,1995943
Louisiana,M11,2002,6.0,120529,1885787,2006316
Louisiana,M10,2002,5.9,118078,1897458,2015536
Louisiana,M09,2002,6.0,119333,1885249,2004582
Louisiana,M08,2002,6.4,128408,1885298,2013706
Louisiana,M07,2002,6.4,131281,1904505,2035786
Louisiana,M06,2002,7.1,144320,1898036,2042356
Louisiana,M05,2002,5.9,118097,1884612,2002709
Louisiana,M04,2002,5.7,113301,1881328,1994629
Louisiana,M03,2002,5.8,114939,1871758,1986697
Louisiana,M02,2002,5.8,114288,1866619,1980907
Louisiana,M01,2002,6.9,135561,1835934,1971495
Louisiana,M12,2001,5.9,117365,1885604,2002969
Louisiana,M11,2001,5.9,119845,1896651,2016496
Louisiana,M10,2001,5.9,119388,1908127,2027515
Louisiana,M09,2001,5.8,116472,1899973,2016445
Louisiana,M08,2001,5.9,119750,1900943,2020693
Louisiana,M07,2001,5.7,117422,1939869,2057291
Louisiana,M06,2001,6.3,130304,1933254,2063558
Louisiana,M05,2001,5.2,105023,1922255,2027278
Louisiana,M04,2001,5.1,104042,1924786,2028828
Louisiana,M03,2001,5.5,111220,1925096,2036316
Louisiana,M02,2001,5.3,107027,1909931,2016958
Louisiana,M01,2001,6.4,129953,1895331,2025284
Louisiana,M12,2000,5.2,105293,1927538,2032831
Louisiana,M11,2000,5.4,110704,1926418,2037122
Louisiana,M10,2000,5.3,108765,1928277,2037042
Louisiana,M09,2000,5.5,110035,1907608,2017643
Louisiana,M08,2000,5.8,117854,1918447,2036301
Louisiana,M07,2000,5.7,116933,1943255,2060188
Louisiana,M06,2000,6.1,126292,1948808,2075100
Louisiana,M05,2000,5.0,102757,1935244,2038001
Louisiana,M04,2000,4.4,88864,1947280,2036144
Louisiana,M03,2000,4.9,100421,1935185,2035606
Louisiana,M02,2000,4.8,97530,1923595,2021125
Louisiana,M01,2000,5.5,110778,1907012,2017790
Arkansas,M12,2016,3.8,50559,1276550,1327109
Arkansas,M11,2016,3.4,45836,1288668,1334504
Arkansas,M10,2016,3.5,46406,1296015,1342421
Arkansas,M09,2016,3.9,52163,1293350,1345513
Arkansas,M08,2016,3.9,52969,1292067,1345036
Arkansas,M07,2016,4.4,59883,1300687,1360570
Arkansas,M06,2016,4.2,57869,1304099,1361968
Arkansas,M05,2016,3.9,52655,1295372,1348027
Arkansas,M04,2016,3.6,48474,1295493,1343967
Arkansas,M03,2016,4.0,54291,1289318,1343609
Arkansas,M02,2016,4.6,61266,1276416,1337682
Arkansas,M01,2016,4.7,61989,1259895,1321884
Arkansas,M12,2015,4.2,55666,1278731,1334397
Arkansas,M11,2015,4.0,53503,1283152,1336655
Arkansas,M10,2015,4.1,54302,1283420,1337722
Arkansas,M09,2015,4.5,59937,1278096,1338033
Arkansas,M08,2015,4.7,63471,1274677,1338148
Arkansas,M07,2015,5.5,73734,1277592,1351326
Arkansas,M06,2015,5.4,72894,1279090,1351984
Arkansas,M05,2015,5.4,71701,1266543,1338244
Arkansas,M04,2015,5.1,67557,1259275,1326832
Arkansas,M03,2015,5.6,73717,1245719,1319436
Arkansas,M02,2015,6.1,80060,1236070,1316130
Arkansas,M01,2015,6.3,82313,1219721,1302034
Arkansas,M12,2014,5.5,72664,1238500,1311164
Arkansas,M11,2014,5.3,69662,1244593,1314255
Arkansas,M10,2014,5.2,67750,1244484,1312234
Arkansas,M09,2014,5.6,73663,1235443,1309106
Arkansas,M08,2014,5.9,76895,1229364,1306259
Arkansas,M07,2014,6.5,85295,1232743,1318038
Arkansas,M06,2014,6.2,81894,1235527,1317421
Arkansas,M05,2014,6.1,79057,1222978,1302035
Arkansas,M04,2014,5.7,74260,1217780,1292040
Arkansas,M03,2014,6.5,83987,1208802,1292789
Arkansas,M02,2014,7.2,92554,1194872,1287426
Arkansas,M01,2014,7.4,93972,1180535,1274507
Arkansas,M12,2013,6.8,87766,1198002,1285768
Arkansas,M11,2013,6.6,85248,1211567,1296815
Arkansas,M10,2013,6.7,86583,1213253,1299836
Arkansas,M09,2013,7.0,91419,1214981,1306400
Arkansas,M08,2013,7.2,94542,1214618,1309160
Arkansas,M07,2013,7.8,103161,1224833,1327994
Arkansas,M06,2013,7.7,102885,1229270,1332155
Arkansas,M05,2013,7.4,97374,1221118,1318492
Arkansas,M04,2013,7.0,92031,1219919,1311950
Arkansas,M03,2013,7.4,96761,1211188,1307949
Arkansas,M02,2013,8.1,105211,1201591,1306802
Arkansas,M01,2013,8.4,108803,1188476,1297279
Arkansas,M12,2012,7.4,97426,1213884,1311310
Arkansas,M11,2012,7.0,91631,1225401,1317032
Arkansas,M10,2012,7.0,92787,1235897,1328684
Arkansas,M09,2012,7.2,96516,1237440,1333956
Arkansas,M08,2012,7.5,100207,1239881,1340088
Arkansas,M07,2012,8.0,109408,1250990,1360398
Arkansas,M06,2012,7.8,106146,1262827,1368973
Arkansas,M05,2012,7.5,101047,1254469,1355516
Arkansas,M04,2012,7.1,95596,1254426,1350022
Arkansas,M03,2012,7.6,103096,1251591,1354687
Arkansas,M02,2012,8.3,111855,1239891,1351746
Arkansas,M01,2012,8.5,113799,1226827,1340626
Arkansas,M12,2011,7.8,106201,1251307,1357508
Arkansas,M11,2011,7.4,100607,1261326,1361933
Arkansas,M10,2011,7.5,102316,1264352,1366668
Arkansas,M09,2011,7.9,107718,1255688,1363406
Arkansas,M08,2011,8.1,110931,1254789,1365720
Arkansas,M07,2011,8.7,120548,1259711,1380259
Arkansas,M06,2011,8.6,118752,1257938,1376690
Arkansas,M05,2011,8.3,113396,1249961,1363357
Arkansas,M04,2011,8.1,110239,1254405,1364644
Arkansas,M03,2011,8.6,116338,1241090,1357428
Arkansas,M02,2011,9.2,123978,1226898,1350876
Arkansas,M01,2011,9.5,126996,1216698,1343694
Arkansas,M12,2010,8.2,111181,1240454,1351635
Arkansas,M11,2010,7.9,107132,1247927,1355059
Arkansas,M10,2010,7.6,103589,1252738,1356327
Arkansas,M09,2010,7.9,106797,1250253,1357050
Arkansas,M08,2010,8.1,109690,1252702,1362392
Arkansas,M07,2010,8.4,115397,1260320,1375717
Arkansas,M06,2010,8.1,111410,1265857,1377267
Arkansas,M05,2010,8.0,108847,1250681,1359528
Arkansas,M04,2010,7.8,105687,1244571,1350258
Arkansas,M03,2010,8.3,111767,1227606,1339373
Arkansas,M02,2010,9.0,119464,1213551,1333015
Arkansas,M01,2010,9.0,119140,1203292,1322432
Arkansas,M12,2009,8.1,108093,1227866,1335959
Arkansas,M11,2009,7.6,101897,1244201,1346098
Arkansas,M10,2009,7.6,102131,1248424,1350555
Arkansas,M09,2009,7.6,102138,1249085,1351223
Arkansas,M08,2009,7.7,104249,1255134,1359383
Arkansas,M07,2009,8.2,113433,1267803,1381236
Arkansas,M06,2009,8.1,112164,1268976,1381140
Arkansas,M05,2009,7.9,108025,1258389,1366414
Arkansas,M04,2009,7.5,102313,1262831,1365144
Arkansas,M03,2009,7.8,106319,1254283,1360602
Arkansas,M02,2009,8.1,109615,1250596,1360211
Arkansas,M01,2009,8.0,107766,1241203,1348969
Arkansas,M12,2008,6.6,90645,1272911,1363556
Arkansas,M11,2008,5.9,80814,1290303,1371117
Arkansas,M10,2008,5.4,74462,1304102,1378564
Arkansas,M09,2008,5.4,74202,1305528,1379730
Arkansas,M08,2008,5.4,74633,1307826,1382459
Arkansas,M07,2008,5.6,78731,1317726,1396457
Arkansas,M06,2008,5.4,74806,1322645,1397451
Arkansas,M05,2008,5.1,70673,1310399,1381072
Arkansas,M04,2008,4.7,64137,1308193,1372330
Arkansas,M03,2008,5.0,68336,1299612,1367948
Arkansas,M02,2008,5.4,74056,1288095,1362151
Arkansas,M01,2008,5.7,77387,1272869,1350256
Arkansas,M12,2007,5.2,70213,1292977,1363190
Arkansas,M11,2007,4.8,65016,1302269,1367285
Arkansas,M10,2007,4.7,64618,1302249,1366867
Arkansas,M09,2007,5.1,70503,1299877,1370380
Arkansas,M08,2007,5.2,71817,1298929,1370746
Arkansas,M07,2007,5.9,81584,1306571,1388155
Arkansas,M06,2007,5.6,77580,1313381,1390961
Arkansas,M05,2007,5.3,72401,1300045,1372446
Arkansas,M04,2007,5.0,68929,1297864,1366793
Arkansas,M03,2007,5.2,71726,1296580,1368306
Arkansas,M02,2007,5.8,78735,1281256,1359991
Arkansas,M01,2007,5.9,79419,1266871,1346290
Arkansas,M12,2006,5.0,68176,1292406,1360582
Arkansas,M11,2006,4.9,66607,1296893,1363500
Arkansas,M10,2006,4.5,61972,1301885,1363857
Arkansas,M09,2006,4.9,67285,1294683,1361968
Arkansas,M08,2006,5.2,70468,1296912,1367380
Arkansas,M07,2006,5.7,78201,1304009,1382210
Arkansas,M06,2006,5.4,75550,1312153,1387703
Arkansas,M05,2006,5.2,71397,1299423,1370820
Arkansas,M04,2006,5.0,67730,1299348,1367078
Arkansas,M03,2006,5.1,70085,1292174,1362259
Arkansas,M02,2006,5.5,75080,1281378,1356458
Arkansas,M01,2006,5.5,73492,1267613,1341105
Arkansas,M12,2005,4.9,66797,1286789,1353586
Arkansas,M11,2005,4.6,61778,1293707,1355485
Arkansas,M10,2005,4.5,60629,1298127,1358756
Arkansas,M09,2005,4.9,65966,1291196,1357162
Arkansas,M08,2005,5.2,70528,1286379,1356907
Arkansas,M07,2005,5.7,77937,1292431,1370368
Arkansas,M06,2005,5.5,75344,1291549,1366893
Arkansas,M05,2005,5.3,70920,1276958,1347878
Arkansas,M04,2005,5.0,66881,1270846,1337727
Arkansas,M03,2005,5.3,70431,1255669,1326100
Arkansas,M02,2005,6.0,78835,1240813,1319648
Arkansas,M01,2005,6.1,79530,1220913,1300443
Arkansas,M12,2004,5.4,70702,1242020,1312722
Arkansas,M11,2004,5.0,65505,1246767,1312272
Arkansas,M10,2004,4.9,64190,1245676,1309866
Arkansas,M09,2004,5.2,67698,1236414,1304112
Arkansas,M08,2004,5.4,71032,1236858,1307890
Arkansas,M07,2004,6.1,80572,1241005,1321577
Arkansas,M06,2004,6.1,80314,1238012,1318326
Arkansas,M05,2004,5.8,75314,1223139,1298453
Arkansas,M04,2004,5.5,71606,1219114,1290720
Arkansas,M03,2004,6.1,77911,1207430,1285341
Arkansas,M02,2004,6.4,81916,1196633,1278549
Arkansas,M01,2004,6.6,83585,1180409,1263994
Arkansas,M12,2003,5.6,71892,1200949,1272841
Arkansas,M11,2003,5.5,69806,1205136,1274942
Arkansas,M10,2003,5.4,68498,1208129,1276627
Arkansas,M09,2003,5.7,72703,1197769,1270472
Arkansas,M08,2003,5.9,74914,1198246,1273160
Arkansas,M07,2003,6.5,83278,1202725,1286003
Arkansas,M06,2003,6.4,82699,1206891,1289590
Arkansas,M05,2003,5.9,75484,1195127,1270611
Arkansas,M04,2003,5.7,71773,1194678,1266451
Arkansas,M03,2003,5.9,74784,1189165,1263949
Arkansas,M02,2003,6.3,79175,1183737,1262912
Arkansas,M01,2003,6.4,79753,1173035,1252788
Arkansas,M12,2002,5.4,67862,1197258,1265120
Arkansas,M11,2002,5.0,62921,1205566,1268487
Arkansas,M10,2002,4.6,59041,1215133,1274174
Arkansas,M09,2002,4.9,62685,1215598,1278283
Arkansas,M08,2002,5.2,66060,1212192,1278252
Arkansas,M07,2002,5.8,74860,1218539,1293399
Arkansas,M06,2002,5.8,74496,1220820,1295316
Arkansas,M05,2002,5.5,69660,1207739,1277399
Arkansas,M04,2002,5.4,69132,1200185,1269317
Arkansas,M03,2002,5.7,72382,1190785,1263167
Arkansas,M02,2002,6.1,76880,1178433,1255313
Arkansas,M01,2002,6.4,78925,1154819,1233744
Arkansas,M12,2001,5.3,65821,1181093,1246914
Arkansas,M11,2001,4.8,59535,1188865,1248400
Arkansas,M10,2001,4.5,55779,1196091,1251870
Arkansas,M09,2001,4.6,58171,1195264,1253435
Arkansas,M08,2001,4.8,60716,1195272,1255988
Arkansas,M07,2001,5.4,68376,1207611,1275987
Arkansas,M06,2001,5.2,66747,1208127,1274874
Arkansas,M05,2001,4.8,60517,1195853,1256370
Arkansas,M04,2001,4.6,57904,1194668,1252572
Arkansas,M03,2001,4.9,61319,1189442,1250761
Arkansas,M02,2001,5.3,66179,1178015,1244194
Arkansas,M01,2001,5.3,65133,1164975,1230108
Arkansas,M12,2000,4.1,51272,1188691,1239963
Arkansas,M11,2000,3.9,48070,1198177,1246247
Arkansas,M10,2000,3.5,44017,1205944,1249961
Arkansas,M09,2000,3.8,47620,1203405,1251025
Arkansas,M08,2000,4.1,51549,1208904,1260453
Arkansas,M07,2000,4.5,57894,1218141,1276035
Arkansas,M06,2000,4.4,56574,1229199,1285773
Arkansas,M05,2000,4.2,53083,1213421,1266504
Arkansas,M04,2000,4.0,50425,1213480,1263905
Arkansas,M03,2000,4.5,56629,1206482,1263111
Arkansas,M02,2000,5.0,62946,1192617,1255563
Arkansas,M01,2000,5.1,63187,1177884,1241071
Oregon,M12,2016,4.2,85717,1967105,2052822
Oregon,M11,2016,4.3,89684,1980731,2070415
Oregon,M10,2016,4.5,94169,1982320,2076489
Oregon,M09,2016,4.6,95099,1980589,2075688
Oregon,M08,2016,5.1,107054,1978769,2085823
Oregon,M07,2016,5.3,110678,1973524,2084202
Oregon,M06,2016,5.3,109759,1964672,2074431
Oregon,M05,2016,4.6,94466,1948925,2043391
Oregon,M04,2016,4.8,98075,1939719,2037794
Oregon,M03,2016,5.2,106457,1927931,2034388
Oregon,M02,2016,5.3,106865,1915645,2022510
Oregon,M01,2016,5.3,105493,1897921,2003414
Oregon,M12,2015,4.9,98945,1908699,2007644
Oregon,M11,2015,5.1,102441,1912771,2015212
Oregon,M10,2015,5.1,102488,1908256,2010744
Oregon,M09,2015,5.1,101570,1898245,1999815
Oregon,M08,2015,5.6,113127,1892530,2005657
Oregon,M07,2015,5.9,118212,1881735,1999947
Oregon,M06,2015,5.8,115237,1870228,1985465
Oregon,M05,2015,5.5,108460,1853182,1961642
Oregon,M04,2015,5.5,107985,1837937,1945922
Oregon,M03,2015,6.1,117361,1819426,1936787
Oregon,M02,2015,6.2,120953,1815500,1936453
Oregon,M01,2015,6.4,123093,1807731,1930824
Oregon,M12,2014,5.8,113007,1825305,1938312
Oregon,M11,2014,6.2,121028,1837728,1958756
Oregon,M10,2014,6.2,120815,1842457,1963272
Oregon,M09,2014,6.1,119766,1836964,1956730
Oregon,M08,2014,6.8,133711,1833768,1967479
Oregon,M07,2014,7.0,137768,1829545,1967313
Oregon,M06,2014,6.8,132110,1817157,1949267
Oregon,M05,2014,6.6,126047,1797194,1923241
Oregon,M04,2014,6.8,129973,1783686,1913659
Oregon,M03,2014,7.7,147564,1765262,1912826
Oregon,M02,2014,8.0,153007,1754321,1907328
Oregon,M01,2014,7.8,148456,1748069,1896525
Oregon,M12,2013,7.1,134537,1763370,1897907
Oregon,M11,2013,7.2,136883,1776047,1912930
Oregon,M10,2013,7.2,136732,1773635,1910367
Oregon,M09,2013,6.9,132978,1781480,1914458
Oregon,M08,2013,7.6,147043,1779493,1926536
Oregon,M07,2013,8.0,153454,1775187,1928641
Oregon,M06,2013,8.0,153988,1765649,1919637
Oregon,M05,2013,7.6,144066,1752042,1896108
Oregon,M04,2013,8.0,150549,1741439,1891988
Oregon,M03,2013,8.7,164314,1726029,1890343
Oregon,M02,2013,9.1,172454,1723961,1896415
Oregon,M01,2013,9.4,178924,1719598,1898522
Oregon,M12,2012,8.5,162735,1748763,1911498
Oregon,M11,2012,8.3,160453,1770250,1930703
Oregon,M10,2012,8.2,158831,1785694,1944525
Oregon,M09,2012,8.0,154880,1789832,1944712
Oregon,M08,2012,8.7,170303,1791673,1961976
Oregon,M07,2012,9.0,176543,1794876,1971419
Oregon,M06,2012,8.9,174432,1794715,1969147
Oregon,M05,2012,8.4,164586,1789296,1953882
Oregon,M04,2012,8.9,173740,1784859,1958599
Oregon,M03,2012,9.6,188981,1776050,1965031
Oregon,M02,2012,9.8,193318,1773917,1967235
Oregon,M01,2012,9.8,192985,1769557,1962542
Oregon,M12,2011,9.1,179652,1798602,1978254
Oregon,M11,2011,8.9,177412,1816746,1994158
Oregon,M10,2011,8.9,177196,1819091,1996287
Oregon,M09,2011,8.8,176682,1821884,1998566
Oregon,M08,2011,9.4,188450,1824668,2013118
Oregon,M07,2011,9.5,191462,1819681,2011143
Oregon,M06,2011,9.6,192711,1814282,2006993
Oregon,M05,2011,9.1,181396,1804685,1986081
Oregon,M04,2011,9.5,188043,1799739,1987782
Oregon,M03,2011,10.2,202693,1785744,1988437
Oregon,M02,2011,10.4,206942,1777028,1983970
Oregon,M01,2011,10.7,212194,1769688,1981882
Oregon,M12,2010,10.0,197501,1787102,1984603
Oregon,M11,2010,10.1,201381,1799204,2000585
Oregon,M10,2010,9.7,192860,1800884,1993744
Oregon,M09,2010,9.7,192749,1798988,1991737
Oregon,M08,2010,10.2,205431,1800750,2006181
Oregon,M07,2010,10.4,207144,1792463,1999607
Oregon,M06,2010,10.6,211982,1781220,1993202
Oregon,M05,2010,10.4,205758,1765954,1971712
Oregon,M04,2010,11.0,218040,1760383,1978423
Oregon,M03,2010,11.9,233665,1737228,1970893
Oregon,M02,2010,11.9,233304,1729397,1962701
Oregon,M01,2010,11.9,231746,1723334,1955080
Oregon,M12,2009,10.8,211141,1740797,1951938
Oregon,M11,2009,10.3,202049,1759626,1961675
Oregon,M10,2009,10.3,202960,1760247,1963207
Oregon,M09,2009,10.3,202876,1762835,1965711
Oregon,M08,2009,11.0,218603,1769779,1988382
Oregon,M07,2009,11.3,225139,1770620,1995759
Oregon,M06,2009,11.7,233779,1758913,1992692
Oregon,M05,2009,11.6,230012,1746325,1976337
Oregon,M04,2009,12.1,239911,1747598,1987509
Oregon,M03,2009,12.6,250173,1734638,1984811
Oregon,M02,2009,12.1,239612,1742676,1982288
Oregon,M01,2009,11.1,219219,1750129,1969348
Oregon,M12,2008,9.1,178997,1788363,1967360
Oregon,M11,2008,8.2,161364,1818089,1979453
Oregon,M10,2008,7.2,141798,1835318,1977116
Oregon,M09,2008,6.4,125730,1840460,1966190
Oregon,M08,2008,6.5,128972,1850255,1979227
Oregon,M07,2008,6.3,123851,1852512,1976363
Oregon,M06,2008,5.9,114763,1844798,1959561
Oregon,M05,2008,5.3,102998,1832013,1935011
Oregon,M04,2008,5.5,105675,1830376,1936051
Oregon,M03,2008,6.0,116066,1816353,1932419
Oregon,M02,2008,6.1,116724,1809765,1926489
Oregon,M01,2008,6.0,116293,1809923,1926216
Oregon,M12,2007,5.2,99755,1829145,1928900
Oregon,M11,2007,4.9,96128,1846432,1942560
Oregon,M10,2007,4.8,92230,1844020,1936250
Oregon,M09,2007,4.6,88811,1841699,1930510
Oregon,M08,2007,5.0,97154,1842358,1939512
Oregon,M07,2007,5.1,99062,1838990,1938052
Oregon,M06,2007,5.0,96736,1833042,1929778
Oregon,M05,2007,4.7,89954,1815304,1905258
Oregon,M04,2007,5.1,98044,1807732,1905776
Oregon,M03,2007,5.6,106668,1798826,1905494
Oregon,M02,2007,5.9,111270,1789952,1901222
Oregon,M01,2007,5.9,112112,1785762,1897874
Oregon,M12,2006,5.0,94426,1810534,1904960
Oregon,M11,2006,5.1,97060,1819038,1916098
Oregon,M10,2006,4.6,88484,1818887,1907371
Oregon,M09,2006,4.6,88021,1809496,1897517
Oregon,M08,2006,5.2,99093,1813285,1912378
Oregon,M07,2006,5.3,101086,1806780,1907866
Oregon,M06,2006,5.3,99804,1795554,1895358
Oregon,M05,2006,5.0,92707,1775493,1868200
Oregon,M04,2006,5.4,101367,1764432,1865799
Oregon,M03,2006,6.0,110653,1745853,1856506
Oregon,M02,2006,6.3,116075,1734564,1850639
Oregon,M01,2006,6.3,115318,1726609,1841927
Oregon,M12,2005,5.4,100241,1744695,1844936
Oregon,M11,2005,5.7,105125,1753201,1858326
Oregon,M10,2005,5.4,100524,1755908,1856432
Oregon,M09,2005,5.4,100336,1750532,1850868
Oregon,M08,2005,6.0,111259,1758077,1869336
Oregon,M07,2005,6.1,114627,1752533,1867160
Oregon,M06,2005,6.2,115839,1741671,1857510
Oregon,M05,2005,6.0,109478,1726131,1835609
Oregon,M04,2005,6.5,118694,1719007,1837701
Oregon,M03,2005,6.9,125849,1701527,1827376
Oregon,M02,2005,7.3,133443,1692506,1825949
Oregon,M01,2005,7.2,131578,1686355,1817933
Oregon,M12,2004,6.4,117305,1707922,1825227
Oregon,M11,2004,6.6,121996,1718277,1840273
Oregon,M10,2004,6.5,119549,1718708,1838257
Oregon,M09,2004,6.4,118006,1716575,1834581
Oregon,M08,2004,7.1,131012,1725680,1856692
Oregon,M07,2004,7.2,134159,1724347,1858506
Oregon,M06,2004,7.4,136569,1715079,1851648
Oregon,M05,2004,7.0,127949,1700189,1828138
Oregon,M04,2004,7.5,137414,1696303,1833717
Oregon,M03,2004,8.4,154219,1679421,1833640
Oregon,M02,2004,8.5,155092,1673923,1829015
Oregon,M01,2004,8.7,159639,1668010,1827649
Oregon,M12,2003,7.4,134861,1693204,1828065
Oregon,M11,2003,7.5,138966,1706289,1845255
Oregon,M10,2003,7.3,134853,1709910,1844763
Oregon,M09,2003,7.4,136094,1706431,1842525
Oregon,M08,2003,8.0,149471,1714847,1864318
Oregon,M07,2003,8.3,155680,1710979,1866659
Oregon,M06,2003,8.6,160782,1705106,1865888
Oregon,M05,2003,8.1,148999,1690461,1839460
Oregon,M04,2003,8.6,158956,1687905,1846861
Oregon,M03,2003,8.8,160917,1677624,1838541
Oregon,M02,2003,8.7,159536,1675234,1834770
Oregon,M01,2003,8.6,156545,1672887,1829432
Oregon,M12,2002,7.3,133453,1692858,1826311
Oregon,M11,2002,7.3,134000,1706972,1840972
Oregon,M10,2002,6.7,124321,1720392,1844713
Oregon,M09,2002,6.5,119700,1724191,1843891
Oregon,M08,2002,7.0,130269,1727311,1857580
Oregon,M07,2002,7.2,133265,1720438,1853703
Oregon,M06,2002,7.3,133770,1708975,1842745
Oregon,M05,2002,7.0,128030,1693388,1821418
Oregon,M04,2002,7.8,143351,1683025,1826376
Oregon,M03,2002,8.5,154145,1669020,1823165
Oregon,M02,2002,8.7,159183,1666023,1825206
Oregon,M01,2002,9.0,163565,1654254,1817819
Oregon,M12,2001,7.6,138618,1682695,1821313
Oregon,M11,2001,7.4,135513,1696747,1832260
Oregon,M10,2001,6.7,122406,1709027,1831433
Oregon,M09,2001,6.3,114495,1714042,1828537
Oregon,M08,2001,6.5,119995,1719350,1839345
Oregon,M07,2001,6.2,113661,1727651,1841312
Oregon,M06,2001,6.1,111253,1721435,1832688
Oregon,M05,2001,5.6,102054,1709440,1811494
Oregon,M04,2001,6.0,109474,1705733,1815207
Oregon,M03,2001,6.3,114781,1700249,1815030
Oregon,M02,2001,6.3,113969,1697861,1811830
Oregon,M01,2001,6.0,107927,1698618,1806545
Oregon,M12,2000,4.7,85094,1723586,1808680
Oregon,M11,2000,4.8,88244,1734210,1822454
Oregon,M10,2000,4.7,85624,1737611,1823235
Oregon,M09,2000,4.4,80780,1735004,1815784
Oregon,M08,2000,5.2,96270,1745063,1841333
Oregon,M07,2000,5.1,93018,1744055,1837073
Oregon,M06,2000,5.0,92300,1742516,1834816
Oregon,M05,2000,4.9,88628,1724582,1813210
Oregon,M04,2000,5.0,91551,1723133,1814684
Oregon,M03,2000,5.7,102913,1706749,1809662
Oregon,M02,2000,5.9,105636,1699582,1805218
Oregon,M01,2000,5.8,103720,1692836,1796556
Iowa,M12,2016,3.6,60330,1624199,1684529
Iowa,M11,2016,3.0,50922,1640695,1691617
Iowa,M10,2016,3.2,54397,1648506,1702903
Iowa,M09,2016,3.4,57646,1640977,1698623
Iowa,M08,2016,3.7,62720,1639716,1702436
Iowa,M07,2016,3.7,63255,1659777,1723032
Iowa,M06,2016,3.8,65910,1650822,1716732
Iowa,M05,2016,3.3,56466,1640785,1697251
Iowa,M04,2016,3.5,58931,1640615,1699546
Iowa,M03,2016,4.0,67435,1631421,1698856
Iowa,M02,2016,4.3,73843,1626211,1700054
Iowa,M01,2016,4.5,76883,1615728,1692611
Iowa,M12,2015,3.8,64455,1629528,1693983
Iowa,M11,2015,3.3,55312,1642230,1697542
Iowa,M10,2015,3.3,56686,1646545,1703231
Iowa,M09,2015,3.4,57630,1635619,1693249
Iowa,M08,2015,3.7,62367,1637636,1700003
Iowa,M07,2015,3.7,63490,1657533,1721023
Iowa,M06,2015,3.9,66743,1651926,1718669
Iowa,M05,2015,3.5,60340,1641601,1701941
Iowa,M04,2015,3.6,60631,1639810,1700441
Iowa,M03,2015,4.2,71653,1628602,1700255
Iowa,M02,2015,4.5,76925,1624505,1701430
Iowa,M01,2015,4.9,82592,1616471,1699063
Iowa,M12,2014,4.1,69874,1630675,1700549
Iowa,M11,2014,3.6,61145,1644076,1705221
Iowa,M10,2014,3.7,63586,1649675,1713261
Iowa,M09,2014,3.9,66224,1638820,1705044
Iowa,M08,2014,4.2,72505,1634816,1707321
Iowa,M07,2014,4.2,72789,1652403,1725192
Iowa,M06,2014,4.3,73624,1645469,1719093
Iowa,M05,2014,3.9,66578,1632250,1698828
Iowa,M04,2014,4.1,69094,1628382,1697476
Iowa,M03,2014,4.9,82944,1614959,1697903
Iowa,M02,2014,5.1,86877,1606080,1692957
Iowa,M01,2014,5.3,90082,1594955,1685037
Iowa,M12,2013,4.4,74594,1608270,1682864
Iowa,M11,2013,4.0,68172,1618437,1686609
Iowa,M10,2013,4.1,69769,1615633,1685402
Iowa,M09,2013,4.3,72448,1610319,1682767
Iowa,M08,2013,4.6,76918,1608403,1685321
Iowa,M07,2013,4.6,78335,1624260,1702595
Iowa,M06,2013,4.9,82159,1610939,1693098
Iowa,M05,2013,4.4,74237,1596673,1670910
Iowa,M04,2013,4.8,79293,1589974,1669267
Iowa,M03,2013,5.3,88026,1573744,1661770
Iowa,M02,2013,5.6,92819,1565706,1658525
Iowa,M01,2013,6.0,99138,1552188,1651326
Iowa,M12,2012,5.0,82028,1567797,1649825
Iowa,M11,2012,4.5,73601,1579266,1652867
Iowa,M10,2012,4.5,74715,1584443,1659158
Iowa,M09,2012,4.6,75443,1572027,1647470
Iowa,M08,2012,4.9,81309,1566990,1648299
Iowa,M07,2012,5.0,82945,1586031,1668976
Iowa,M06,2012,5.1,84402,1581396,1665798
Iowa,M05,2012,4.7,76910,1572090,1649000
Iowa,M04,2012,4.8,78359,1570095,1648454
Iowa,M03,2012,5.5,90665,1559929,1650594
Iowa,M02,2012,6.0,98496,1553831,1652327
Iowa,M01,2012,6.1,100272,1544654,1644926
Iowa,M12,2011,5.5,90049,1559690,1649739
Iowa,M11,2011,5.0,82031,1572993,1655024
Iowa,M10,2011,5.0,82229,1576377,1658606
Iowa,M09,2011,5.2,85465,1566403,1651868
Iowa,M08,2011,5.4,90193,1566645,1656838
Iowa,M07,2011,5.2,87885,1586964,1674849
Iowa,M06,2011,5.6,93418,1579990,1673408
Iowa,M05,2011,5.2,85460,1573510,1658970
Iowa,M04,2011,5.3,88423,1575326,1663749
Iowa,M03,2011,6.1,101860,1566454,1668314
Iowa,M02,2011,6.4,107685,1562061,1669746
Iowa,M01,2011,6.7,111695,1555711,1667406
Iowa,M12,2010,5.9,98837,1575088,1673925
Iowa,M11,2010,5.4,91117,1587216,1678333
Iowa,M10,2010,5.3,88485,1591654,1680139
Iowa,M09,2010,5.5,92103,1581707,1673810
Iowa,M08,2010,5.8,96775,1579137,1675912
Iowa,M07,2010,5.6,95549,1597893,1693442
Iowa,M06,2010,5.9,98881,1591012,1689893
Iowa,M05,2010,5.6,94095,1582091,1676186
Iowa,M04,2010,5.9,98609,1581266,1679875
Iowa,M03,2010,6.9,115278,1562288,1677566
Iowa,M02,2010,7.1,119414,1553985,1673399
Iowa,M01,2010,7.3,120860,1546023,1666883
Iowa,M12,2009,6.5,109007,1560574,1669581
Iowa,M11,2009,5.9,98329,1579429,1677758
Iowa,M10,2009,6.0,101904,1584033,1685937
Iowa,M09,2009,5.9,99137,1576116,1675253
Iowa,M08,2009,6.4,107436,1578831,1686267
Iowa,M07,2009,6.4,109042,1599272,1708314
Iowa,M06,2009,6.6,112895,1592857,1705752
Iowa,M05,2009,6.2,105285,1583078,1688363
Iowa,M04,2009,6.3,106655,1584827,1691482
Iowa,M03,2009,7.0,118513,1572781,1691294
Iowa,M02,2009,6.9,115872,1571809,1687681
Iowa,M01,2009,6.8,113875,1567365,1681240
Iowa,M12,2008,5.4,90021,1592024,1682045
Iowa,M11,2008,4.4,73964,1611529,1685493
Iowa,M10,2008,4.0,67004,1621777,1688781
Iowa,M09,2008,4.0,68054,1612377,1680431
Iowa,M08,2008,4.2,70102,1611219,1681321
Iowa,M07,2008,4.0,68317,1632742,1701059
Iowa,M06,2008,4.0,68279,1623591,1691870
Iowa,M05,2008,3.6,59543,1612805,1672348
Iowa,M04,2008,3.8,63413,1611406,1674819
Iowa,M03,2008,4.2,70777,1597949,1668726
Iowa,M02,2008,4.4,72685,1591269,1663954
Iowa,M01,2008,4.5,75020,1585653,1660673
Iowa,M12,2007,3.8,63540,1601396,1664936
Iowa,M11,2007,3.3,55220,1616922,1672142
Iowa,M10,2007,3.3,54519,1616640,1671159
Iowa,M09,2007,3.4,56121,1604602,1660723
Iowa,M08,2007,3.4,57163,1599795,1656958
Iowa,M07,2007,3.3,55952,1621180,1677132
Iowa,M06,2007,3.6,61065,1612772,1673837
Iowa,M05,2007,3.3,54944,1596545,1651489
Iowa,M04,2007,3.7,60767,1590926,1651693
Iowa,M03,2007,4.2,68650,1582010,1650660
Iowa,M02,2007,4.5,73645,1576772,1650417
Iowa,M01,2007,4.5,74553,1572424,1646977
Iowa,M12,2006,3.8,62300,1596756,1659056
Iowa,M11,2006,3.4,56052,1611380,1667432
Iowa,M10,2006,3.2,53737,1618858,1672595
Iowa,M09,2006,3.4,56669,1606082,1662751
Iowa,M08,2006,3.6,59533,1605391,1664924
Iowa,M07,2006,3.4,57562,1623216,1680778
Iowa,M06,2006,3.6,60177,1614081,1674258
Iowa,M05,2006,3.3,54194,1598104,1652298
Iowa,M04,2006,3.5,58077,1591100,1649177
Iowa,M03,2006,4.1,66717,1575355,1642072
Iowa,M02,2006,4.4,71883,1565105,1636988
Iowa,M01,2006,4.7,75749,1552931,1628680
Iowa,M12,2005,4.4,72235,1568094,1640329
Iowa,M11,2005,3.8,62886,1578876,1641762
Iowa,M10,2005,3.7,60042,1583871,1643913
Iowa,M09,2005,3.8,62364,1569886,1632250
Iowa,M08,2005,3.9,64295,1569097,1633392
Iowa,M07,2005,4.0,65585,1586244,1651829
Iowa,M06,2005,4.2,68914,1572482,1641396
Iowa,M05,2005,3.9,64004,1558082,1622086
Iowa,M04,2005,4.1,66707,1553405,1620112
Iowa,M03,2005,4.8,78044,1538016,1616060
Iowa,M02,2005,5.1,82966,1528072,1611038
Iowa,M01,2005,5.4,87094,1515898,1602992
Iowa,M12,2004,4.6,73205,1532254,1605459
Iowa,M11,2004,4.2,67857,1542961,1610818
Iowa,M10,2004,4.1,65883,1543774,1609657
Iowa,M09,2004,4.3,67983,1530118,1598101
Iowa,M08,2004,4.4,70163,1532853,1603016
Iowa,M07,2004,4.2,68495,1552952,1621447
Iowa,M06,2004,4.5,73007,1540051,1613058
Iowa,M05,2004,4.1,65046,1525981,1591027
Iowa,M04,2004,4.2,66786,1524353,1591139
Iowa,M03,2004,5.0,79373,1514174,1593547
Iowa,M02,2004,5.1,81697,1512487,1594184
Iowa,M01,2004,5.3,84830,1505173,1590003
Iowa,M12,2003,4.5,71999,1523248,1595247
Iowa,M11,2003,4.1,65810,1536544,1602354
Iowa,M10,2003,4.0,63840,1541329,1605169
Iowa,M09,2003,4.2,66541,1527118,1593659
Iowa,M08,2003,4.4,69548,1527872,1597420
Iowa,M07,2003,4.4,70491,1548879,1619370
Iowa,M06,2003,4.6,75329,1545053,1620382
Iowa,M05,2003,4.1,66194,1535011,1601205
Iowa,M04,2003,4.5,72129,1537286,1609415
Iowa,M03,2003,5.0,80464,1530872,1611336
Iowa,M02,2003,5.1,81662,1531927,1613589
Iowa,M01,2003,5.2,83705,1528728,1612433
Iowa,M12,2002,4.2,67227,1552213,1619440
Iowa,M11,2002,3.7,61032,1569097,1630129
Iowa,M10,2002,3.5,57756,1583943,1641699
Iowa,M09,2002,3.6,59077,1579510,1638587
Iowa,M08,2002,3.8,62695,1579023,1641718
Iowa,M07,2002,3.7,61571,1599058,1660629
Iowa,M06,2002,4.0,65878,1592214,1658092
Iowa,M05,2002,3.5,57372,1581044,1638416
Iowa,M04,2002,4.0,65437,1574469,1639906
Iowa,M03,2002,4.5,74094,1561023,1635117
Iowa,M02,2002,4.6,75083,1557663,1632746
Iowa,M01,2002,4.8,76969,1541458,1618427
Iowa,M12,2001,3.8,61642,1560365,1622007
Iowa,M11,2001,3.4,55130,1569212,1624342
Iowa,M10,2001,3.0,49497,1575187,1624684
Iowa,M09,2001,3.0,49259,1566037,1615296
Iowa,M08,2001,3.1,49893,1560175,1610068
Iowa,M07,2001,2.9,47258,1582190,1629448
Iowa,M06,2001,3.2,51859,1569883,1621742
Iowa,M05,2001,2.8,45445,1556906,1602351
Iowa,M04,2001,3.2,51997,1553933,1605930
Iowa,M03,2001,3.8,60748,1545116,1605864
Iowa,M02,2001,3.7,59947,1539762,1599709
Iowa,M01,2001,3.9,62004,1532130,1594134
Iowa,M12,2000,2.9,46938,1548695,1595633
Iowa,M11,2000,2.6,41280,1555735,1597015
Iowa,M10,2000,2.3,37099,1558887,1595986
Iowa,M09,2000,2.3,37123,1544998,1582121
Iowa,M08,2000,2.5,39423,1546437,1585860
Iowa,M07,2000,2.3,36279,1566462,1602741
Iowa,M06,2000,2.5,40709,1558869,1599578
Iowa,M05,2000,2.3,36274,1545853,1582127
Iowa,M04,2000,2.4,38022,1550159,1588181
Iowa,M03,2000,2.8,44602,1542253,1586855
Iowa,M02,2000,3.2,50582,1537328,1587910
Iowa,M01,2000,3.4,53471,1527952,1581423
Massachusetts,M12,2016,2.8,98949,3476092,3575041
Massachusetts,M11,2016,2.8,98720,3484968,3583688
Massachusetts,M10,2016,2.8,101927,3474819,3576746
Massachusetts,M09,2016,3.3,119229,3448828,3568057
Massachusetts,M08,2016,3.4,123037,3499594,3622631
Massachusetts,M07,2016,3.9,139969,3494733,3634702
Massachusetts,M06,2016,4.0,145385,3483459,3628844
Massachusetts,M05,2016,3.7,131194,3438413,3569607
Massachusetts,M04,2016,3.8,136232,3435391,3571623
Massachusetts,M03,2016,4.4,157457,3426999,3584456
Massachusetts,M02,2016,4.6,165935,3412558,3578493
Massachusetts,M01,2016,4.9,175361,3394075,3569436
Massachusetts,M12,2015,4.2,150878,3426093,3576971
Massachusetts,M11,2015,4.3,152636,3431616,3584252
Massachusetts,M10,2015,4.3,152072,3421936,3574008
Massachusetts,M09,2015,4.7,165567,3389053,3554620
Massachusetts,M08,2015,4.6,166670,3449322,3615992
Massachusetts,M07,2015,5.1,184597,3442283,3626880
Massachusetts,M06,2015,5.2,186885,3437220,3624105
Massachusetts,M05,2015,4.9,173700,3394340,3568040
Massachusetts,M04,2015,4.7,165525,3390392,3555917
Massachusetts,M03,2015,5.2,184911,3374251,3559162
Massachusetts,M02,2015,5.5,196186,3363745,3559931
Massachusetts,M01,2015,5.8,206764,3349653,3556417
Massachusetts,M12,2014,4.9,175681,3385268,3560949
Massachusetts,M11,2014,5.1,181167,3396819,3577986
Massachusetts,M10,2014,5.1,180405,3391179,3571584
Massachusetts,M09,2014,5.7,200910,3349367,3550277
Massachusetts,M08,2014,5.7,206301,3396679,3602980
Massachusetts,M07,2014,6.1,219212,3388291,3607503
Massachusetts,M06,2014,6.0,214753,3379776,3594529
Massachusetts,M05,2014,5.6,197629,3327567,3525196
Massachusetts,M04,2014,5.5,193796,3320854,3514650
Massachusetts,M03,2014,6.2,219722,3306162,3525884
Massachusetts,M02,2014,6.5,228736,3282314,3511050
Massachusetts,M01,2014,6.8,236802,3265647,3502449
Massachusetts,M12,2013,6.0,209163,3296276,3505439
Massachusetts,M11,2013,6.1,212926,3300898,3513824
Massachusetts,M10,2013,6.2,217417,3278421,3495838
Massachusetts,M09,2013,6.6,231832,3268513,3500345
Massachusetts,M08,2013,6.6,233647,3318385,3552032
Massachusetts,M07,2013,7.0,250860,3313457,3564317
Massachusetts,M06,2013,7.3,258626,3307455,3566081
Massachusetts,M05,2013,6.7,234009,3263671,3497680
Massachusetts,M04,2013,6.5,228370,3260088,3488458
Massachusetts,M03,2013,7.0,242331,3241861,3484192
Massachusetts,M02,2013,7.2,250471,3231774,3482245
Massachusetts,M01,2013,7.6,265190,3217764,3482954
Massachusetts,M12,2012,6.6,228992,3264498,3493490
Massachusetts,M11,2012,6.3,219777,3278265,3498042
Massachusetts,M10,2012,6.2,218585,3281859,3500444
Massachusetts,M09,2012,6.6,229800,3249427,3479227
Massachusetts,M08,2012,6.6,231745,3292485,3524230
Massachusetts,M07,2012,6.9,244361,3288117,3532478
Massachusetts,M06,2012,6.9,242997,3287348,3530345
Massachusetts,M05,2012,6.4,220127,3240682,3460809
Massachusetts,M04,2012,6.3,216130,3234759,3450889
Massachusetts,M03,2012,6.8,234841,3221505,3456346
Massachusetts,M02,2012,7.2,247850,3203192,3451042
Massachusetts,M01,2012,7.4,256351,3188240,3444591
Massachusetts,M12,2011,6.6,227241,3238999,3466240
Massachusetts,M11,2011,6.4,222129,3249125,3471254
Massachusetts,M10,2011,6.5,225617,3241111,3466728
Massachusetts,M09,2011,7.1,246474,3210447,3456921
Massachusetts,M08,2011,6.9,243136,3264421,3507557
Massachusetts,M07,2011,7.4,258798,3246961,3505759
Massachusetts,M06,2011,7.6,266117,3242899,3509016
Massachusetts,M05,2011,7.1,243206,3201602,3444808
Massachusetts,M04,2011,7.2,246420,3198446,3444866
Massachusetts,M03,2011,7.7,266040,3190182,3456222
Massachusetts,M02,2011,8.1,279796,3169463,3449259
Massachusetts,M01,2011,8.5,293670,3159392,3453062
Massachusetts,M12,2010,7.6,264352,3201242,3465594
Massachusetts,M11,2010,7.7,268236,3206657,3474893
Massachusetts,M10,2010,7.5,258385,3204124,3462509
Massachusetts,M09,2010,8.0,277923,3184101,3462024
Massachusetts,M08,2010,7.9,277055,3242955,3520010
Massachusetts,M07,2010,8.3,294190,3231554,3525744
Massachusetts,M06,2010,8.4,297261,3227963,3525224
Massachusetts,M05,2010,8.2,284514,3182451,3466965
Massachusetts,M04,2010,8.3,288876,3186318,3475194
Massachusetts,M03,2010,8.9,308887,3155759,3464646
Massachusetts,M02,2010,9.2,319371,3138201,3457572
Massachusetts,M01,2010,9.6,332131,3128488,3460619
Massachusetts,M12,2009,8.5,294287,3157430,3451717
Massachusetts,M11,2009,8.3,287078,3182629,3469707
Massachusetts,M10,2009,8.2,285378,3174544,3459922
Massachusetts,M09,2009,8.6,298761,3156122,3454883
Massachusetts,M08,2009,8.2,289311,3232035,3521346
Massachusetts,M07,2009,8.4,296530,3237750,3534280
Massachusetts,M06,2009,8.3,293594,3230783,3524377
Massachusetts,M05,2009,7.7,265663,3183622,3449285
Massachusetts,M04,2009,7.3,253103,3193620,3446723
Massachusetts,M03,2009,7.8,267350,3176046,3443396
Massachusetts,M02,2009,7.9,272365,3170769,3443134
Massachusetts,M01,2009,7.9,273038,3172773,3445811
Massachusetts,M12,2008,6.6,227694,3237757,3465451
Massachusetts,M11,2008,6.1,210847,3261125,3471972
Massachusetts,M10,2008,5.7,197602,3270487,3468089
Massachusetts,M09,2008,5.9,204353,3245848,3450201
Massachusetts,M08,2008,5.6,195388,3307188,3502576
Massachusetts,M07,2008,5.7,199372,3309778,3509150
Massachusetts,M06,2008,5.6,196055,3302091,3498146
Massachusetts,M05,2008,5.0,171873,3251272,3423145
Massachusetts,M04,2008,4.6,157820,3254565,3412385
Massachusetts,M03,2008,5.0,171813,3241801,3413614
Massachusetts,M02,2008,5.2,175405,3226688,3402093
Massachusetts,M01,2008,5.4,184500,3228297,3412797
Massachusetts,M12,2007,4.4,151274,3272497,3423771
Massachusetts,M11,2007,4.1,142373,3294426,3436799
Massachusetts,M10,2007,4.0,135343,3282394,3417737
Massachusetts,M09,2007,4.5,152391,3260327,3412718
Massachusetts,M08,2007,4.3,147834,3311232,3459066
Massachusetts,M07,2007,4.7,165169,3313207,3478376
Massachusetts,M06,2007,4.8,167837,3305168,3473005
Massachusetts,M05,2007,4.4,149922,3250265,3400187
Massachusetts,M04,2007,4.5,151558,3242390,3393948
Massachusetts,M03,2007,4.8,163072,3243796,3406868
Massachusetts,M02,2007,5.2,177319,3222238,3399557
Massachusetts,M01,2007,5.6,190865,3219207,3410072
Massachusetts,M12,2006,4.6,157090,3275768,3432858
Massachusetts,M11,2006,4.5,155914,3279812,3435726
Massachusetts,M10,2006,4.3,146131,3278710,3424841
Massachusetts,M09,2006,4.9,166663,3239146,3405809
Massachusetts,M08,2006,4.7,161993,3300847,3462840
Massachusetts,M07,2006,5.0,173389,3291608,3464997
Massachusetts,M06,2006,5.1,175370,3282325,3457695
Massachusetts,M05,2006,4.7,160410,3223036,3383446
Massachusetts,M04,2006,4.9,164772,3209064,3373836
Massachusetts,M03,2006,5.2,174607,3204544,3379151
Massachusetts,M02,2006,5.4,183196,3188788,3371984
Massachusetts,M01,2006,5.5,184743,3182147,3366890
Massachusetts,M12,2005,4.6,156125,3227279,3383404
Massachusetts,M11,2005,4.7,157812,3234471,3392283
Massachusetts,M10,2005,4.4,148349,3239490,3387839
Massachusetts,M09,2005,4.9,165476,3205502,3370978
Massachusetts,M08,2005,4.5,152653,3276346,3428999
Massachusetts,M07,2005,4.9,166819,3267397,3434216
Massachusetts,M06,2005,5.0,170182,3255066,3425248
Massachusetts,M05,2005,4.6,153736,3207078,3360814
Massachusetts,M04,2005,4.7,156901,3198714,3355615
Massachusetts,M03,2005,5.1,172261,3186270,3358531
Massachusetts,M02,2005,5.4,181642,3173982,3355624
Massachusetts,M01,2005,5.6,186373,3169473,3355846
Massachusetts,M12,2004,4.5,153196,3221396,3374592
Massachusetts,M11,2004,4.5,151375,3233408,3384783
Massachusetts,M10,2004,4.4,148197,3227532,3375729
Massachusetts,M09,2004,4.9,163859,3198437,3362296
Massachusetts,M08,2004,4.8,166091,3264996,3431087
Massachusetts,M07,2004,5.3,182638,3263742,3446380
Massachusetts,M06,2004,5.5,189129,3253075,3442204
Massachusetts,M05,2004,5.1,171047,3203592,3374639
Massachusetts,M04,2004,5.1,170379,3203377,3373756
Massachusetts,M03,2004,5.7,192381,3197121,3389502
Massachusetts,M02,2004,5.8,195853,3193787,3389640
Massachusetts,M01,2004,6.2,211935,3189590,3401525
Massachusetts,M12,2003,5.2,177666,3231306,3408972
Massachusetts,M11,2003,5.3,180527,3238804,3419331
Massachusetts,M10,2003,5.2,178220,3231217,3409437
Massachusetts,M09,2003,5.8,195807,3202152,3397959
Massachusetts,M08,2003,5.7,195356,3259892,3455248
Massachusetts,M07,2003,5.9,205636,3256797,3462433
Massachusetts,M06,2003,6.1,212892,3260235,3473127
Massachusetts,M05,2003,5.6,190219,3213245,3403464
Massachusetts,M04,2003,5.5,188747,3217199,3405946
Massachusetts,M03,2003,5.9,201206,3210012,3411218
Massachusetts,M02,2003,6.0,204700,3203754,3408454
Massachusetts,M01,2003,6.3,214157,3199155,3413312
Massachusetts,M12,2002,5.2,179764,3244765,3424529
Massachusetts,M11,2002,5.2,177108,3254046,3431154
Massachusetts,M10,2002,5.0,172448,3264576,3437024
Massachusetts,M09,2002,5.4,186306,3245943,3432249
Massachusetts,M08,2002,5.3,184127,3295281,3479408
Massachusetts,M07,2002,5.5,192672,3288984,3481656
Massachusetts,M06,2002,5.5,192471,3284496,3476967
Massachusetts,M05,2002,5.0,169851,3241072,3410923
Massachusetts,M04,2002,5.0,171607,3231102,3402709
Massachusetts,M03,2002,5.3,180637,3228101,3408738
Massachusetts,M02,2002,5.3,179444,3223852,3403296
Massachusetts,M01,2002,5.5,185533,3198802,3384335
Massachusetts,M12,2001,4.2,143919,3253815,3397734
Massachusetts,M11,2001,4.0,136597,3257564,3394161
Massachusetts,M10,2001,3.7,126790,3257738,3384528
Massachusetts,M09,2001,4.0,133507,3238404,3371911
Massachusetts,M08,2001,3.8,129041,3285177,3414218
Massachusetts,M07,2001,3.9,132735,3299340,3432075
Massachusetts,M06,2001,3.8,130288,3289427,3419715
Massachusetts,M05,2001,3.3,109682,3244677,3354359
Massachusetts,M04,2001,3.2,108562,3241381,3349943
Massachusetts,M03,2001,3.6,121740,3244828,3366568
Massachusetts,M02,2001,3.5,118156,3228787,3346943
Massachusetts,M01,2001,3.7,122822,3220469,3343291
Massachusetts,M12,2000,2.4,80322,3261666,3341988
Massachusetts,M11,2000,2.3,75993,3256445,3332438
Massachusetts,M10,2000,2.1,70030,3248854,3318884
Massachusetts,M09,2000,2.5,83192,3213720,3296912
Massachusetts,M08,2000,2.5,83174,3272344,3355518
Massachusetts,M07,2000,2.8,94849,3266458,3361307
Massachusetts,M06,2000,2.8,94571,3273547,3368118
Massachusetts,M05,2000,2.5,81350,3218001,3299351
Massachusetts,M04,2000,2.4,81006,3229432,3310438
Massachusetts,M03,2000,3.1,102231,3220226,3322457
Massachusetts,M02,2000,3.3,111032,3213762,3324794
Massachusetts,M01,2000,3.6,121431,3208485,3329916
New York,M12,2016,4.5,420764,9016545,9437309
New York,M11,2016,4.5,428310,9067995,9496305
New York,M10,2016,4.8,455099,9092934,9548033
New York,M09,2016,4.9,471384,9083479,9554863
New York,M08,2016,4.9,474278,9152826,9627104
New York,M07,2016,5.0,487956,9208843,9696799
New York,M06,2016,4.7,455409,9189246,9644655
New York,M05,2016,4.3,414684,9152009,9566693
New York,M04,2016,4.6,439358,9137622,9576980
New York,M03,2016,5.1,488592,9161575,9650167
New York,M02,2016,5.3,511796,9127083,9638879
New York,M01,2016,5.3,509899,9065724,9575623
New York,M12,2015,4.7,452588,9099149,9551737
New York,M11,2015,4.8,459022,9084879,9543901
New York,M10,2015,4.7,448791,9103708,9552499
New York,M09,2015,4.8,451687,9050253,9501940
New York,M08,2015,4.9,474347,9143075,9617422
New York,M07,2015,5.3,516141,9178078,9694219
New York,M06,2015,5.2,506257,9169192,9675449
New York,M05,2015,5.3,511162,9128411,9639573
New York,M04,2015,5.3,503889,9074527,9578416
New York,M03,2015,5.7,545038,9031064,9576102
New York,M02,2015,6.2,598407,8992334,9590741
New York,M01,2015,6.4,612104,8960453,9572557
New York,M12,2014,5.5,525322,8985135,9510457
New York,M11,2014,5.8,554485,9005641,9560126
New York,M10,2014,5.6,540873,9046041,9586914
New York,M09,2014,5.8,550240,8962996,9513236
New York,M08,2014,6.2,592694,9004603,9597297
New York,M07,2014,6.5,625936,9049902,9675838
New York,M06,2014,6.2,598356,9035367,9633723
New York,M05,2014,6.2,593382,8960739,9554121
New York,M04,2014,6.1,574754,8924913,9499667
New York,M03,2014,7.1,677725,8919074,9596799
New York,M02,2014,7.5,722329,8860280,9582609
New York,M01,2014,7.4,707156,8830554,9537710
New York,M12,2013,6.7,640419,8877991,9518410
New York,M11,2013,7.0,674232,8896428,9570660
New York,M10,2013,7.4,711607,8864162,9575769
New York,M09,2013,7.5,717560,8912767,9630327
New York,M08,2013,7.6,738313,8962386,9700699
New York,M07,2013,7.8,765455,9002682,9768137
New York,M06,2013,7.8,762896,8971281,9734177
New York,M05,2013,7.5,720290,8917835,9638125
New York,M04,2013,7.4,704852,8867536,9572388
New York,M03,2013,8.0,759977,8796406,9556383
New York,M02,2013,8.7,832423,8763998,9596421
New York,M01,2013,9.1,874915,8740538,9615453
New York,M12,2012,8.1,780531,8827014,9607545
New York,M11,2012,7.8,744437,8848186,9592623
New York,M10,2012,8.0,775887,8901067,9676954
New York,M09,2012,8.0,770858,8836721,9607579
New York,M08,2012,8.5,819852,8820927,9640779
New York,M07,2012,8.9,869303,8855026,9724329
New York,M06,2012,8.7,847344,8858766,9706110
New York,M05,2012,8.4,810111,8802540,9612651
New York,M04,2012,8.2,781708,8743936,9525644
New York,M03,2012,8.9,849589,8717093,9566682
New York,M02,2012,9.4,896719,8673664,9570383
New York,M01,2012,9.2,879821,8635675,9515496
New York,M12,2011,8.4,801667,8726027,9527694
New York,M11,2011,8.2,779975,8747192,9527167
New York,M10,2011,8.2,786747,8760081,9546828
New York,M09,2011,8.3,789134,8726310,9515444
New York,M08,2011,8.2,786711,8784635,9571346
New York,M07,2011,8.4,802883,8780064,9582947
New York,M06,2011,8.2,782485,8760229,9542714
New York,M05,2011,7.8,740067,8740381,9480448
New York,M04,2011,7.8,736437,8729548,9465985
New York,M03,2011,8.2,781659,8701218,9482877
New York,M02,2011,8.8,834190,8647877,9482067
New York,M01,2011,9.0,849694,8633127,9482821
New York,M12,2010,8.2,778927,8697247,9476174
New York,M11,2010,8.4,800042,8718557,9518599
New York,M10,2010,8.2,780123,8767814,9547937
New York,M09,2010,8.2,789479,8785730,9575209
New York,M08,2010,8.4,811144,8866954,9678098
New York,M07,2010,8.6,839019,8882378,9721397
New York,M06,2010,8.4,809639,8865867,9675506
New York,M05,2010,8.2,792560,8824164,9616724
New York,M04,2010,8.5,816515,8832434,9648949
New York,M03,2010,9.1,870834,8703452,9574286
New York,M02,2010,9.5,905984,8659214,9565198
New York,M01,2010,9.6,913397,8632868,9546265
New York,M12,2009,8.8,830518,8659858,9490376
New York,M11,2009,8.5,813304,8752554,9565858
New York,M10,2009,8.7,830227,8758706,9588933
New York,M09,2009,8.6,823544,8764073,9587617
New York,M08,2009,8.5,824239,8915014,9739253
New York,M07,2009,8.5,839765,8982250,9822015
New York,M06,2009,8.4,820334,8938340,9758674
New York,M05,2009,8.0,772957,8862580,9635537
New York,M04,2009,7.7,743565,8892977,9636542
New York,M03,2009,8.2,790037,8842188,9632225
New York,M02,2009,8.3,798673,8866043,9664716
New York,M01,2009,7.8,748821,8899246,9648067
New York,M12,2008,6.5,630096,9043764,9673860
New York,M11,2008,5.9,573044,9123834,9696878
New York,M10,2008,5.6,547381,9180460,9727841
New York,M09,2008,5.5,535656,9140174,9675830
New York,M08,2008,5.5,541033,9219404,9760437
New York,M07,2008,5.4,534071,9279123,9813194
New York,M06,2008,5.1,495640,9238810,9734450
New York,M05,2008,4.9,475046,9133266,9608312
New York,M04,2008,4.6,439668,9139731,9579399
New York,M03,2008,5.2,493552,9079370,9572922
New York,M02,2008,5.4,517695,9038573,9556268
New York,M01,2008,5.5,525439,9052450,9577889
New York,M12,2007,4.8,457213,9093206,9550419
New York,M11,2007,4.4,424968,9138707,9563675
New York,M10,2007,4.4,422315,9102924,9525239
New York,M09,2007,4.5,427843,9078301,9506144
New York,M08,2007,4.5,433427,9125196,9558623
New York,M07,2007,4.9,472753,9195730,9668483
New York,M06,2007,4.5,429851,9164410,9594261
New York,M05,2007,4.2,395958,9049004,9444962
New York,M04,2007,4.2,394382,9024388,9418770
New York,M03,2007,4.4,414052,9057783,9471835
New York,M02,2007,4.9,460426,9015431,9475857
New York,M01,2007,5.0,473001,9013408,9486409
New York,M12,2006,4.0,380112,9127709,9507821
New York,M11,2006,4.1,389205,9116899,9506104
New York,M10,2006,3.9,369322,9134232,9503554
New York,M09,2006,4.2,396191,9051369,9447560
New York,M08,2006,4.4,421192,9156330,9577522
New York,M07,2006,4.8,465836,9183505,9649341
New York,M06,2006,4.5,428459,9161864,9590323
New York,M05,2006,4.5,421611,9048619,9470230
New York,M04,2006,4.6,435725,9021835,9457560
New York,M03,2006,5.0,469084,9002066,9471150
New York,M02,2006,5.3,506410,8968580,9474990
New York,M01,2006,5.1,484298,8957345,9441643
New York,M12,2005,4.7,444914,9028067,9472981
New York,M11,2005,5.1,483175,9018572,9501747
New York,M10,2005,4.8,457716,9064157,9521873
New York,M09,2005,5.0,478594,8999285,9477879
New York,M08,2005,4.7,445045,9122581,9567626
New York,M07,2005,5.1,486644,9125789,9612433
New York,M06,2005,4.8,460307,9054869,9515176
New York,M05,2005,4.8,447903,8963522,9411425
New York,M04,2005,4.8,448980,8934143,9383123
New York,M03,2005,5.0,466757,8869796,9336553
New York,M02,2005,5.7,537258,8835340,9372598
New York,M01,2005,5.7,530785,8826182,9356967
New York,M12,2004,5.2,491247,8906169,9397416
New York,M11,2004,5.1,479541,8921421,9400962
New York,M10,2004,5.1,479071,8914851,9393922
New York,M09,2004,5.2,486382,8846048,9332430
New York,M08,2004,5.3,502791,8957216,9460007
New York,M07,2004,5.8,552734,8976552,9529286
New York,M06,2004,5.8,549936,8879859,9429795
New York,M05,2004,5.6,518046,8753449,9271495
New York,M04,2004,5.9,542439,8715329,9257768
New York,M03,2004,6.7,626040,8654206,9280246
New York,M02,2004,6.8,631794,8622334,9254128
New York,M01,2004,7.1,659999,8603980,9263979
New York,M12,2003,6.1,564761,8654526,9219287
New York,M11,2003,6.3,586050,8664475,9250525
New York,M10,2003,6.2,574985,8665667,9240652
New York,M09,2003,6.3,577315,8611360,9188675
New York,M08,2003,6.2,576628,8716269,9292897
New York,M07,2003,6.4,598353,8750684,9349037
New York,M06,2003,6.4,601941,8747510,9349451
New York,M05,2003,6.0,555733,8655932,9211665
New York,M04,2003,6.1,564253,8670520,9234773
New York,M03,2003,6.4,596335,8652415,9248750
New York,M02,2003,6.9,636658,8652700,9289358
New York,M01,2003,7.0,652893,8632850,9285743
New York,M12,2002,6.3,579910,8697278,9277188
New York,M11,2002,6.1,569423,8693805,9263228
New York,M10,2002,5.8,536360,8768436,9304796
New York,M09,2002,5.6,521143,8758465,9279608
New York,M08,2002,5.8,539498,8817921,9357419
New York,M07,2002,6.1,570602,8819400,9390002
New York,M06,2002,6.0,557064,8775346,9332410
New York,M05,2002,5.9,541849,8693491,9235340
New York,M04,2002,6.1,565785,8651810,9217595
New York,M03,2002,6.6,606896,8625608,9232504
New York,M02,2002,6.8,626602,8627952,9254554
New York,M01,2002,6.8,626829,8534707,9161536
New York,M12,2001,5.9,543430,8644575,9188005
New York,M11,2001,5.7,521046,8638238,9159284
New York,M10,2001,5.4,490378,8669970,9160348
New York,M09,2001,5.0,456566,8672816,9129382
New York,M08,2001,4.9,450314,8726766,9177080
New York,M07,2001,4.6,424779,8827791,9252570
New York,M06,2001,4.3,396872,8787430,9184302
New York,M05,2001,4.0,362719,8705502,9068221
New York,M04,2001,4.1,372755,8701391,9074146
New York,M03,2001,4.5,409534,8729809,9139343
New York,M02,2001,4.7,431863,8710662,9142525
New York,M01,2001,4.8,441925,8703814,9145739
New York,M12,2000,4.1,371369,8764571,9135940
New York,M11,2000,4.3,387271,8717791,9105062
New York,M10,2000,4.2,380430,8723466,9103896
New York,M09,2000,4.3,387741,8668829,9056570
New York,M08,2000,4.5,410289,8771062,9181351
New York,M07,2000,4.6,420770,8804396,9225166
New York,M06,2000,4.3,395389,8802696,9198085
New York,M05,2000,4.4,399551,8683388,9082939
New York,M04,2000,4.3,396178,8713447,9109625
New York,M03,2000,5.0,459536,8678431,9137967
New York,M02,2000,5.3,485168,8662014,9147182
New York,M01,2000,5.3,487748,8634893,9122641
Rhode Island,M12,2016,4.5,24653,525543,550196
Rhode Island,M11,2016,4.6,25413,527799,553212
Rhode Island,M10,2016,4.7,25753,526364,552117
Rhode Island,M09,2016,4.9,27069,525340,552409
Rhode Island,M08,2016,5.5,30925,527631,558556
Rhode Island,M07,2016,5.6,31448,528936,560384
Rhode Island,M06,2016,5.1,28574,527601,556175
Rhode Island,M05,2016,5.3,28907,519500,548407
Rhode Island,M04,2016,5.1,27892,519433,547325
Rhode Island,M03,2016,5.9,32590,516191,548781
Rhode Island,M02,2016,6.2,34090,515382,549472
Rhode Island,M01,2016,6.5,35567,514023,549590
Rhode Island,M12,2015,5.1,28357,524555,552912
Rhode Island,M11,2015,5.3,29200,526000,555200
Rhode Island,M10,2015,5.1,28427,524292,552719
Rhode Island,M09,2015,5.2,28737,523595,552332
Rhode Island,M08,2015,5.9,33161,525983,559144
Rhode Island,M07,2015,6.0,33944,527192,561136
Rhode Island,M06,2015,5.8,32202,525702,557904
Rhode Island,M05,2015,6.0,33364,518739,552103
Rhode Island,M04,2015,5.9,32249,516945,549194
Rhode Island,M03,2015,6.9,38109,511415,549524
Rhode Island,M02,2015,7.2,39670,510215,549885
Rhode Island,M01,2015,7.5,41679,510428,552107
Rhode Island,M12,2014,6.2,34523,519990,554513
Rhode Island,M11,2014,6.5,35915,520483,556398
Rhode Island,M10,2014,6.5,35795,518406,554201
Rhode Island,M09,2014,6.8,37853,517197,555050
Rhode Island,M08,2014,7.5,41927,518743,560670
Rhode Island,M07,2014,7.7,43102,518919,562021
Rhode Island,M06,2014,7.3,40724,517216,557940
Rhode Island,M05,2014,7.8,42864,509510,552374
Rhode Island,M04,2014,7.9,43324,507820,551144
Rhode Island,M03,2014,9.0,49670,502505,552175
Rhode Island,M02,2014,9.4,52070,501637,553707
Rhode Island,M01,2014,9.9,54902,499915,554817
Rhode Island,M12,2013,8.7,48474,509248,557722
Rhode Island,M11,2013,8.8,49138,511225,560363
Rhode Island,M10,2013,8.7,48693,509541,558234
Rhode Island,M09,2013,8.8,49362,508790,558152
Rhode Island,M08,2013,9.4,52657,510400,563057
Rhode Island,M07,2013,9.4,52783,511137,563920
Rhode Island,M06,2013,8.8,49489,510079,559568
Rhode Island,M05,2013,9.1,49983,502042,552025
Rhode Island,M04,2013,9.0,49465,501255,550720
Rhode Island,M03,2013,9.8,53971,498102,552073
Rhode Island,M02,2013,10.1,55792,498038,553830
Rhode Island,M01,2013,10.5,58327,497404,555731
Rhode Island,M12,2012,9.2,51242,507398,558640
Rhode Island,M11,2012,9.4,52889,507778,560667
Rhode Island,M10,2012,9.5,53139,506491,559630
Rhode Island,M09,2012,9.6,53888,505644,559532
Rhode Island,M08,2012,10.2,57543,506195,563738
Rhode Island,M07,2012,10.5,59122,505295,564417
Rhode Island,M06,2012,10.1,56621,503950,560571
Rhode Island,M05,2012,10.4,57373,496049,553422
Rhode Island,M04,2012,10.4,57706,494850,552556
Rhode Island,M03,2012,11.4,63248,491507,554755
Rhode Island,M02,2012,11.8,65900,490971,556871
Rhode Island,M01,2012,12.2,67962,489076,557038
Rhode Island,M12,2011,10.9,61279,498656,559935
Rhode Island,M11,2011,10.9,61483,500808,562291
Rhode Island,M10,2011,10.8,60294,499817,560111
Rhode Island,M09,2011,10.6,59317,499135,558452
Rhode Island,M08,2011,11.0,61850,501715,563565
Rhode Island,M07,2011,11.1,62654,503399,566053
Rhode Island,M06,2011,10.5,59167,503186,562353
Rhode Island,M05,2011,10.7,59363,496484,555847
Rhode Island,M04,2011,10.7,59351,496588,555939
Rhode Island,M03,2011,11.5,64108,493013,557121
Rhode Island,M02,2011,11.7,65538,493161,558699
Rhode Island,M01,2011,12.0,67294,493013,560307
Rhode Island,M12,2010,10.8,60991,503848,564839
Rhode Island,M11,2010,10.7,60965,506563,567528
Rhode Island,M10,2010,10.6,60015,505238,565253
Rhode Island,M09,2010,10.7,60774,505438,566212
Rhode Island,M08,2010,11.3,64596,509315,573911
Rhode Island,M07,2010,11.4,65730,509589,575319
Rhode Island,M06,2010,10.9,62000,507685,569685
Rhode Island,M05,2010,11.2,62895,500937,563832
Rhode Island,M04,2010,11.2,63124,500266,563390
Rhode Island,M03,2010,11.7,65807,496781,562588
Rhode Island,M02,2010,11.9,66801,496625,563426
Rhode Island,M01,2010,12.1,68157,496305,564462
Rhode Island,M12,2009,10.7,60631,505461,566092
Rhode Island,M11,2009,10.6,60335,507678,568013
Rhode Island,M10,2009,10.6,59667,505857,565524
Rhode Island,M09,2009,10.7,60543,504857,565400
Rhode Island,M08,2009,11.2,63800,507712,571512
Rhode Island,M07,2009,11.4,65371,508524,573895
Rhode Island,M06,2009,10.9,61892,508197,570089
Rhode Island,M05,2009,11.0,62053,501462,563515
Rhode Island,M04,2009,11.1,62617,501623,564240
Rhode Island,M03,2009,11.4,64477,500391,564868
Rhode Island,M02,2009,11.3,63825,503048,566873
Rhode Island,M01,2009,11.1,62739,504605,567344
Rhode Island,M12,2008,9.2,52740,517596,570336
Rhode Island,M11,2008,8.7,49631,522055,571686
Rhode Island,M10,2008,8.2,46801,522841,569642
Rhode Island,M09,2008,8.0,45341,524291,569632
Rhode Island,M08,2008,8.2,47381,528320,575701
Rhode Island,M07,2008,8.1,46955,530057,577012
Rhode Island,M06,2008,7.3,41747,531322,573069
Rhode Island,M05,2008,7.1,40311,525852,566163
Rhode Island,M04,2008,6.9,38938,527278,566216
Rhode Island,M03,2008,7.2,40985,525605,566590
Rhode Island,M02,2008,7.2,40690,527278,567968
Rhode Island,M01,2008,7.2,41120,528799,569919
Rhode Island,M12,2007,5.6,32056,540170,572226
Rhode Island,M11,2007,5.2,29967,543722,573689
Rhode Island,M10,2007,5.0,28783,543181,571964
Rhode Island,M09,2007,5.0,28460,543741,572201
Rhode Island,M08,2007,5.4,31224,547570,578794
Rhode Island,M07,2007,5.5,31744,549386,581130
Rhode Island,M06,2007,4.8,27397,549236,576633
Rhode Island,M05,2007,4.7,26987,542239,569226
Rhode Island,M04,2007,4.7,26991,541717,568708
Rhode Island,M03,2007,5.2,29854,539589,569443
Rhode Island,M02,2007,5.5,31217,539985,571202
Rhode Island,M01,2007,5.7,32587,540276,572863
Rhode Island,M12,2006,4.3,24831,550601,575432
Rhode Island,M11,2006,4.3,24570,551868,576438
Rhode Island,M10,2006,4.2,24162,549815,573977
Rhode Island,M09,2006,4.4,24958,548266,573224
Rhode Island,M08,2006,5.0,28920,549787,578707
Rhode Island,M07,2006,5.3,30539,549210,579749
Rhode Island,M06,2006,4.8,27717,548583,576300
Rhode Island,M05,2006,4.8,27266,540721,567987
Rhode Island,M04,2006,4.8,27485,540508,567993
Rhode Island,M03,2006,5.5,30971,535640,566611
Rhode Island,M02,2006,5.8,32774,534173,566947
Rhode Island,M01,2006,6.1,34736,533108,567844
Rhode Island,M12,2005,4.7,26880,543381,570261
Rhode Island,M11,2005,4.6,26093,545255,571348
Rhode Island,M10,2005,4.5,25832,543025,568857
Rhode Island,M09,2005,4.6,26266,542118,568384
Rhode Island,M08,2005,5.2,29589,544702,574291
Rhode Island,M07,2005,5.4,30779,544057,574836
Rhode Island,M06,2005,4.9,27651,541461,569112
Rhode Island,M05,2005,4.8,26748,532963,559711
Rhode Island,M04,2005,4.8,26837,531621,558458
Rhode Island,M03,2005,5.5,30732,526768,557500
Rhode Island,M02,2005,5.7,31818,526088,557906
Rhode Island,M01,2005,6.0,33266,524893,558159
Rhode Island,M12,2004,4.5,25279,534616,559895
Rhode Island,M11,2004,4.4,24735,536507,561242
Rhode Island,M10,2004,4.3,24287,534667,558954
Rhode Island,M09,2004,4.5,25160,533120,558280
Rhode Island,M08,2004,5.2,29116,535447,564563
Rhode Island,M07,2004,5.5,30880,535594,566474
Rhode Island,M06,2004,5.0,28179,533618,561797
Rhode Island,M05,2004,5.0,27888,526223,554111
Rhode Island,M04,2004,5.4,29733,524391,554124
Rhode Island,M03,2004,5.8,32368,521209,553577
Rhode Island,M02,2004,6.0,33015,521695,554710
Rhode Island,M01,2004,6.3,34896,521626,556522
Rhode Island,M12,2003,4.8,26883,532255,559138
Rhode Island,M11,2003,4.7,26396,534761,561157
Rhode Island,M10,2003,4.7,26342,533595,559937
Rhode Island,M09,2003,4.8,27119,533170,560289
Rhode Island,M08,2003,5.4,30552,536159,566711
Rhode Island,M07,2003,5.6,31933,536813,568746
Rhode Island,M06,2003,5.2,29573,536048,565621
Rhode Island,M05,2003,5.1,28645,528473,557118
Rhode Island,M04,2003,5.2,28991,527223,556214
Rhode Island,M03,2003,5.9,32949,523250,556199
Rhode Island,M02,2003,6.1,33955,522850,556805
Rhode Island,M01,2003,6.4,35650,522207,557857
Rhode Island,M12,2002,4.8,26753,530556,557309
Rhode Island,M11,2002,4.6,25782,531190,556972
Rhode Island,M10,2002,4.5,25096,528562,553658
Rhode Island,M09,2002,4.6,25397,527110,552507
Rhode Island,M08,2002,5.1,28375,528532,556907
Rhode Island,M07,2002,5.2,29213,527402,556615
Rhode Island,M06,2002,4.8,26500,526035,552535
Rhode Island,M05,2002,4.7,25732,518216,543948
Rhode Island,M04,2002,4.7,25692,517041,542733
Rhode Island,M03,2002,5.3,28638,513864,542502
Rhode Island,M02,2002,5.5,30003,513362,543365
Rhode Island,M01,2002,5.9,31905,512115,544020
Rhode Island,M12,2001,4.3,23361,521399,544760
Rhode Island,M11,2001,4.3,23271,522266,545537
Rhode Island,M10,2001,4.2,23021,520857,543878
Rhode Island,M09,2001,4.3,23195,520517,543712
Rhode Island,M08,2001,4.8,26159,523067,549226
Rhode Island,M07,2001,5.0,27329,523207,550536
Rhode Island,M06,2001,4.5,24535,522383,546918
Rhode Island,M05,2001,4.3,23280,515375,538655
Rhode Island,M04,2001,4.2,22803,515915,538718
Rhode Island,M03,2001,4.9,26209,513913,540122
Rhode Island,M02,2001,4.9,26664,514880,541544
Rhode Island,M01,2001,5.2,27989,514754,542743
Rhode Island,M12,2000,3.6,19511,525323,544834
Rhode Island,M11,2000,3.6,19573,526740,546313
Rhode Island,M10,2000,3.6,19685,524626,544311
Rhode Island,M09,2000,3.7,20358,523119,543477
Rhode Island,M08,2000,4.2,23297,525443,548740
Rhode Island,M07,2000,4.4,24293,526377,550670
Rhode Island,M06,2000,4.0,21812,525714,547526
Rhode Island,M05,2000,3.9,20927,518899,539826
Rhode Island,M04,2000,3.7,19977,518312,538289
Rhode Island,M03,2000,4.4,23530,514459,537989
Rhode Island,M02,2000,4.8,26019,513572,539591
Rhode Island,M01,2000,5.2,27991,513167,541158
Georgia,M12,2016,5.2,258411,4723100,4981511
Georgia,M11,2016,5.1,251828,4723599,4975427
Georgia,M10,2016,5.6,276234,4695974,4972208
Georgia,M09,2016,5.5,274962,4682394,4957356
Georgia,M08,2016,5.6,273846,4646987,4920833
Georgia,M07,2016,5.7,283213,4665723,4948936
Georgia,M06,2016,5.6,273846,4640961,4914807
Georgia,M05,2016,4.9,241857,4656162,4898019
Georgia,M04,2016,5.0,245777,4634923,4880700
Georgia,M03,2016,5.3,260822,4633313,4894135
Georgia,M02,2016,5.4,264387,4602750,4867137
Georgia,M01,2016,5.5,265324,4569175,4834499
Georgia,M12,2015,5.4,259434,4569787,4829221
Georgia,M11,2015,5.4,258379,4547094,4805473
Georgia,M10,2015,5.7,272180,4521095,4793275
Georgia,M09,2015,5.7,270850,4499577,4770427
Georgia,M08,2015,6.0,286397,4481581,4767978
Georgia,M07,2015,6.4,307241,4499342,4806583
Georgia,M06,2015,6.4,306070,4491609,4797679
Georgia,M05,2015,6.1,295414,4516710,4812124
Georgia,M04,2015,5.7,270836,4495293,4766129
Georgia,M03,2015,6.0,284453,4484434,4768887
Georgia,M02,2015,6.3,300869,4464491,4765360
Georgia,M01,2015,6.5,311995,4453235,4765230
Georgia,M12,2014,6.1,291096,4465588,4756684
Georgia,M11,2014,6.3,300840,4463629,4764469
Georgia,M10,2014,6.7,317541,4450888,4768429
Georgia,M09,2014,6.9,329281,4425778,4755059
Georgia,M08,2014,7.7,364999,4393662,4758661
Georgia,M07,2014,8.0,385526,4418017,4803543
Georgia,M06,2014,7.6,364238,4407399,4771637
Georgia,M05,2014,7.2,342484,4423871,4766355
Georgia,M04,2014,6.6,312432,4411283,4723715
Georgia,M03,2014,7.3,349480,4411345,4760825
Georgia,M02,2014,7.5,355470,4379531,4735001
Georgia,M01,2014,7.4,349691,4370662,4720353
Georgia,M12,2013,7.3,347269,4382734,4730003
Georgia,M11,2013,7.3,345669,4382536,4728205
Georgia,M10,2013,8.0,377781,4346309,4724090
Georgia,M09,2013,7.9,375228,4372833,4748061
Georgia,M08,2013,8.3,392021,4349499,4741520
Georgia,M07,2013,8.8,422726,4375090,4797816
Georgia,M06,2013,9.0,429978,4364012,4793990
Georgia,M05,2013,8.2,391258,4392139,4783397
Georgia,M04,2013,7.8,372141,4377165,4749306
Georgia,M03,2013,8.2,387534,4364306,4751840
Georgia,M02,2013,8.7,413285,4352593,4765878
Georgia,M01,2013,9.2,439751,4346545,4786296
Georgia,M12,2012,8.7,417812,4379223,4797035
Georgia,M11,2012,8.4,399922,4385530,4785452
Georgia,M10,2012,8.8,421341,4383802,4805143
Georgia,M09,2012,8.7,417163,4369647,4786810
Georgia,M08,2012,9.4,449040,4322334,4771374
Georgia,M07,2012,9.8,471571,4346347,4817918
Georgia,M06,2012,9.7,466230,4344686,4810916
Georgia,M05,2012,9.0,432637,4364584,4797221
Georgia,M04,2012,8.8,420315,4341042,4761357
Georgia,M03,2012,9.3,444208,4337097,4781305
Georgia,M02,2012,9.7,464606,4309632,4774238
Georgia,M01,2012,9.8,466557,4293077,4759634
Georgia,M12,2011,9.7,464985,4329057,4794042
Georgia,M11,2011,9.5,453416,4327137,4780553
Georgia,M10,2011,10.1,484027,4299517,4783544
Georgia,M09,2011,10.4,497810,4288364,4786174
Georgia,M08,2011,10.6,506432,4257526,4763958
Georgia,M07,2011,10.7,509050,4256602,4765652
Georgia,M06,2011,10.8,512454,4239060,4751514
Georgia,M05,2011,10.0,474010,4269047,4743057
Georgia,M04,2011,9.7,457159,4254019,4711178
Georgia,M03,2011,10.0,470617,4242476,4713093
Georgia,M02,2011,10.4,486320,4207461,4693781
Georgia,M01,2011,10.8,509108,4189390,4698498
Georgia,M12,2010,10.6,500248,4221004,4721252
Georgia,M11,2010,10.7,505909,4212921,4718830
Georgia,M10,2010,10.5,490549,4200359,4690908
Georgia,M09,2010,10.5,493268,4206387,4699655
Georgia,M08,2010,10.8,504714,4187570,4692284
Georgia,M07,2010,10.7,500134,4193233,4693367
Georgia,M06,2010,10.6,492775,4175163,4667938
Georgia,M05,2010,10.1,469745,4203148,4672893
Georgia,M04,2010,9.9,460951,4202956,4663907
Georgia,M03,2010,10.4,485492,4175423,4660915
Georgia,M02,2010,10.9,509056,4178229,4687285
Georgia,M01,2010,10.9,522646,4268234,4790880
Georgia,M12,2009,10.4,497163,4285416,4782579
Georgia,M11,2009,10.2,491461,4305024,4796485
Georgia,M10,2009,10.5,500170,4279680,4779850
Georgia,M09,2009,10.3,494303,4285660,4779963
Georgia,M08,2009,10.3,494225,4292956,4787181
Georgia,M07,2009,10.5,506753,4322886,4829639
Georgia,M06,2009,10.5,506610,4305683,4812293
Georgia,M05,2009,9.5,454138,4327016,4781154
Georgia,M04,2009,9.0,430540,4336583,4767123
Georgia,M03,2009,9.4,450643,4329089,4779732
Georgia,M02,2009,9.5,453867,4331050,4784917
Georgia,M01,2009,9.0,430867,4341199,4772066
Georgia,M12,2008,8.1,389049,4398925,4787974
Georgia,M11,2008,7.3,348210,4421511,4769721
Georgia,M10,2008,7.2,342767,4437557,4780324
Georgia,M09,2008,6.7,323986,4482288,4806274
Georgia,M08,2008,6.6,325861,4638156,4964017
Georgia,M07,2008,6.5,322338,4664282,4986620
Georgia,M06,2008,6.1,302548,4646443,4948991
Georgia,M05,2008,5.6,277996,4656642,4934638
Georgia,M04,2008,5.0,247179,4657465,4904644
Georgia,M03,2008,5.2,257321,4646801,4904122
Georgia,M02,2008,5.3,256239,4623661,4879900
Georgia,M01,2008,5.3,257418,4626387,4883805
Georgia,M12,2007,5.0,246364,4647716,4894080
Georgia,M11,2007,4.6,222616,4653057,4875673
Georgia,M10,2007,4.7,229201,4615923,4845124
Georgia,M09,2007,4.7,226514,4610367,4836881
Georgia,M08,2007,4.6,222985,4583238,4806223
Georgia,M07,2007,5.0,240181,4606477,4846658
Georgia,M06,2007,4.7,226592,4583986,4810578
Georgia,M05,2007,4.1,196987,4586650,4783637
Georgia,M04,2007,4.1,193998,4573024,4767022
Georgia,M03,2007,4.0,191268,4591568,4782836
Georgia,M02,2007,4.3,204377,4563519,4767896
Georgia,M01,2007,4.5,217051,4556149,4773200
Georgia,M12,2006,4.3,207219,4596835,4804054
Georgia,M11,2006,4.4,208314,4575077,4783391
Georgia,M10,2006,4.5,212047,4548039,4760086
Georgia,M09,2006,4.6,219933,4513277,4733210
Georgia,M08,2006,4.9,229887,4494135,4724022
Georgia,M07,2006,5.2,247280,4495186,4742466
Georgia,M06,2006,5.1,238282,4471488,4709770
Georgia,M05,2006,4.7,219529,4466796,4686325
Georgia,M04,2006,4.5,210883,4448910,4659793
Georgia,M03,2006,4.5,211133,4444553,4655686
Georgia,M02,2006,4.9,229282,4415626,4644908
Georgia,M01,2006,4.9,225969,4399619,4625588
Georgia,M12,2005,4.9,226058,4425505,4651563
Georgia,M11,2005,5.2,241667,4406909,4648576
Georgia,M10,2005,5.3,246829,4390762,4637591
Georgia,M09,2005,5.7,262277,4367627,4629904
Georgia,M08,2005,5.3,242841,4361740,4604581
Georgia,M07,2005,5.6,260412,4360780,4621192
Georgia,M06,2005,5.7,259493,4325234,4584727
Georgia,M05,2005,5.3,240477,4332422,4572899
Georgia,M04,2005,5.1,233468,4313528,4546996
Georgia,M03,2005,5.2,235272,4288674,4523946
Georgia,M02,2005,5.6,254371,4265319,4519690
Georgia,M01,2005,5.3,239194,4256180,4495374
Georgia,M12,2004,5.1,232679,4289380,4522059
Georgia,M11,2004,5.0,223567,4284070,4507637
Georgia,M10,2004,4.9,221330,4259348,4480678
Georgia,M09,2004,4.8,212619,4237418,4450037
Georgia,M08,2004,5.0,223854,4236717,4460571
Georgia,M07,2004,5.2,232824,4251023,4483847
Georgia,M06,2004,5.3,238030,4217777,4455807
Georgia,M05,2004,4.5,200423,4225847,4426270
Georgia,M04,2004,4.2,185665,4221568,4407233
Georgia,M03,2004,4.4,195969,4222647,4418616
Georgia,M02,2004,4.2,185492,4215858,4401350
Georgia,M01,2004,4.5,200370,4207124,4407494
Georgia,M12,2003,4.0,174968,4237296,4412264
Georgia,M11,2003,4.3,187948,4226941,4414889
Georgia,M10,2003,4.4,194746,4201799,4396545
Georgia,M09,2003,4.6,202181,4182666,4384847
Georgia,M08,2003,4.9,214659,4172102,4386761
Georgia,M07,2003,5.4,236471,4179547,4416018
Georgia,M06,2003,5.7,254276,4168701,4422977
Georgia,M05,2003,4.9,213750,4175946,4389696
Georgia,M04,2003,4.8,209068,4174827,4383895
Georgia,M03,2003,4.8,212328,4172079,4384407
Georgia,M02,2003,4.9,214956,4157297,4372253
Georgia,M01,2003,5.2,227646,4141049,4368695
Georgia,M12,2002,4.9,216111,4166673,4382784
Georgia,M11,2002,4.8,211269,4147550,4358819
Georgia,M10,2002,4.8,207652,4149098,4356750
Georgia,M09,2002,4.8,206733,4144082,4350815
Georgia,M08,2002,5.1,220531,4113941,4334472
Georgia,M07,2002,5.2,226065,4113324,4339389
Georgia,M06,2002,5.4,234357,4096479,4330836
Georgia,M05,2002,4.8,208014,4106830,4314844
Georgia,M04,2002,4.9,212511,4085303,4297814
Georgia,M03,2002,5.1,218756,4087383,4306139
Georgia,M02,2002,5.1,217696,4079917,4297613
Georgia,M01,2002,5.2,222112,4039903,4262015
Georgia,M12,2001,4.7,200563,4095183,4295746
Georgia,M11,2001,4.6,195499,4081354,4276853
Georgia,M10,2001,4.6,194578,4074644,4269222
Georgia,M09,2001,4.2,178241,4073065,4251306
Georgia,M08,2001,4.2,179696,4049622,4229318
Georgia,M07,2001,4.0,170477,4093484,4263961
Georgia,M06,2001,4.1,175539,4076926,4252465
Georgia,M05,2001,3.4,143353,4095154,4238507
Georgia,M04,2001,3.6,153931,4096119,4250050
Georgia,M03,2001,3.7,158630,4123020,4281650
Georgia,M02,2001,3.7,156390,4110397,4266787
Georgia,M01,2001,3.8,162892,4105735,4268627
Georgia,M12,2000,3.0,129048,4134257,4263305
Georgia,M11,2000,3.0,128657,4100789,4229446
Georgia,M10,2000,3.3,137555,4081125,4218680
Georgia,M09,2000,3.5,146555,4063109,4209664
Georgia,M08,2000,3.9,164397,4060662,4225059
Georgia,M07,2000,3.9,165992,4075181,4241173
Georgia,M06,2000,4.0,168502,4067365,4235867
Georgia,M05,2000,3.7,155898,4063847,4219745
Georgia,M04,2000,3.3,138511,4071886,4210397
Georgia,M03,2000,3.8,158596,4064879,4223475
Georgia,M02,2000,3.7,157572,4046970,4204542
Georgia,M01,2000,3.8,157066,4028619,4185685
Kentucky,M12,2016,4.5,90832,1918411,2009243
Kentucky,M11,2016,4.2,84844,1918087,2002931
Kentucky,M10,2016,4.6,91044,1906107,1997151
Kentucky,M09,2016,4.8,96448,1903829,2000277
Kentucky,M08,2016,4.8,95780,1894274,1990054
Kentucky,M07,2016,5.1,103089,1901705,2004794
Kentucky,M06,2016,5.3,107207,1909842,2017049
Kentucky,M05,2016,4.8,96565,1894689,1991254
Kentucky,M04,2016,4.6,91540,1888023,1979563
Kentucky,M03,2016,5.5,108376,1875277,1983653
Kentucky,M02,2016,5.9,116114,1854827,1970941
Kentucky,M01,2016,5.9,114577,1842209,1956786
Kentucky,M12,2015,5.2,103425,1871826,1975251
Kentucky,M11,2015,5.0,98006,1872604,1970610
Kentucky,M10,2015,4.7,91893,1864344,1956237
Kentucky,M09,2015,4.8,93766,1858278,1952044
Kentucky,M08,2015,4.9,95406,1854577,1949983
Kentucky,M07,2015,5.7,112714,1860842,1973556
Kentucky,M06,2015,5.5,109989,1879693,1989682
Kentucky,M05,2015,5.4,106032,1870062,1976094
Kentucky,M04,2015,4.9,95452,1866610,1962062
Kentucky,M03,2015,5.6,110547,1854261,1964808
Kentucky,M02,2015,5.9,114655,1842715,1957370
Kentucky,M01,2015,6.0,117837,1842455,1960292
Kentucky,M12,2014,5.0,97621,1874411,1972032
Kentucky,M11,2014,5.1,100257,1882651,1982908
Kentucky,M10,2014,5.0,99155,1883300,1982455
Kentucky,M09,2014,5.4,107711,1876665,1984376
Kentucky,M08,2014,6.0,119230,1870796,1990026
Kentucky,M07,2014,6.7,134473,1882583,2017056
Kentucky,M06,2014,6.7,136425,1899906,2036331
Kentucky,M05,2014,6.7,136623,1888076,2024699
Kentucky,M04,2014,6.4,129653,1888095,2017748
Kentucky,M03,2014,7.9,159932,1876954,2036886
Kentucky,M02,2014,8.4,169990,1856903,2026893
Kentucky,M01,2014,8.0,161394,1853398,2014792
Kentucky,M12,2013,7.1,144703,1884356,2029059
Kentucky,M11,2013,7.3,148716,1891543,2040259
Kentucky,M10,2013,7.7,157130,1880591,2037721
Kentucky,M09,2013,7.8,159267,1894145,2053412
Kentucky,M08,2013,7.9,160966,1886482,2047448
Kentucky,M07,2013,8.4,173227,1897275,2070502
Kentucky,M06,2013,8.6,180161,1914994,2095155
Kentucky,M05,2013,8.1,168127,1907753,2075880
Kentucky,M04,2013,7.7,158575,1905543,2064118
Kentucky,M03,2013,8.4,174328,1890349,2064677
Kentucky,M02,2013,8.8,181266,1876515,2057781
Kentucky,M01,2013,8.9,182825,1870754,2053579
Kentucky,M12,2012,7.9,163325,1904478,2067803
Kentucky,M11,2012,7.4,152687,1908010,2060697
Kentucky,M10,2012,7.6,156683,1908571,2065254
Kentucky,M09,2012,7.8,160195,1902026,2062221
Kentucky,M08,2012,8.2,168447,1885069,2053516
Kentucky,M07,2012,8.6,177483,1895397,2072880
Kentucky,M06,2012,8.4,176643,1914041,2090684
Kentucky,M05,2012,8.0,164647,1898972,2063619
Kentucky,M04,2012,7.5,153746,1892342,2046088
Kentucky,M03,2012,8.5,173600,1879505,2053105
Kentucky,M02,2012,9.0,184478,1858111,2042589
Kentucky,M01,2012,9.0,183640,1847427,2031067
Kentucky,M12,2011,8.4,171265,1879204,2050469
Kentucky,M11,2011,8.3,171375,1881790,2053165
Kentucky,M10,2011,8.6,176987,1872570,2049557
Kentucky,M09,2011,9.1,188024,1870015,2058039
Kentucky,M08,2011,9.1,187106,1859996,2047102
Kentucky,M07,2011,9.8,201922,1861060,2062982
Kentucky,M06,2011,9.7,201427,1878209,2079636
Kentucky,M05,2011,9.4,194586,1868006,2062592
Kentucky,M04,2011,9.1,187776,1868358,2056134
Kentucky,M03,2011,10.0,205575,1855806,2061381
Kentucky,M02,2011,10.6,217010,1832735,2049745
Kentucky,M01,2011,10.7,218733,1827381,2046114
Kentucky,M12,2010,9.5,195614,1858013,2053627
Kentucky,M11,2010,9.7,199936,1859386,2059322
Kentucky,M10,2010,9.4,192069,1853532,2045601
Kentucky,M09,2010,9.6,196583,1854744,2051327
Kentucky,M08,2010,9.8,200511,1847502,2048013
Kentucky,M07,2010,10.1,207355,1852763,2060118
Kentucky,M06,2010,10.0,208474,1867523,2075997
Kentucky,M05,2010,10.0,206687,1854781,2061468
Kentucky,M04,2010,10.0,205656,1854301,2059957
Kentucky,M03,2010,11.0,225506,1826447,2051953
Kentucky,M02,2010,11.9,242983,1803752,2046735
Kentucky,M01,2010,11.5,235329,1803060,2038389
Kentucky,M12,2009,10.1,205414,1836616,2042030
Kentucky,M11,2009,9.8,201275,1852204,2053479
Kentucky,M10,2009,10.0,203595,1841969,2045564
Kentucky,M09,2009,10.1,207607,1844842,2052449
Kentucky,M08,2009,10.4,214285,1847940,2062225
Kentucky,M07,2009,10.8,225482,1860917,2086399
Kentucky,M06,2009,11.0,230548,1871543,2102091
Kentucky,M05,2009,10.6,220286,1855024,2075310
Kentucky,M04,2009,10.0,205367,1855989,2061356
Kentucky,M03,2009,10.7,220892,1838932,2059824
Kentucky,M02,2009,10.7,218212,1827389,2045601
Kentucky,M01,2009,10.0,203464,1832150,2035614
Kentucky,M12,2008,7.9,161817,1881338,2043155
Kentucky,M11,2008,6.8,138525,1896382,2034907
Kentucky,M10,2008,6.5,131081,1897442,2028523
Kentucky,M09,2008,6.6,133284,1898619,2031903
Kentucky,M08,2008,6.6,133942,1902466,2036408
Kentucky,M07,2008,6.5,133906,1917396,2051302
Kentucky,M06,2008,6.5,133469,1930392,2063861
Kentucky,M05,2008,5.9,119402,1913516,2032918
Kentucky,M04,2008,5.4,109702,1909833,2019535
Kentucky,M03,2008,6.1,123015,1895765,2018780
Kentucky,M02,2008,6.2,123636,1879630,2003266
Kentucky,M01,2008,5.9,118885,1885411,2004296
Kentucky,M12,2007,5.3,106587,1918367,2024954
Kentucky,M11,2007,4.7,95644,1931948,2027592
Kentucky,M10,2007,4.8,97147,1919284,2016431
Kentucky,M09,2007,5.0,101857,1923112,2024969
Kentucky,M08,2007,5.0,101396,1917071,2018467
Kentucky,M07,2007,5.5,111926,1935471,2047397
Kentucky,M06,2007,5.4,112353,1951592,2063945
Kentucky,M05,2007,5.2,105338,1931182,2036520
Kentucky,M04,2007,5.1,104290,1924049,2028339
Kentucky,M03,2007,5.9,120445,1919092,2039537
Kentucky,M02,2007,6.6,133120,1895939,2029059
Kentucky,M01,2007,6.3,128240,1899537,2027777
Kentucky,M12,2006,5.0,102097,1942152,2044249
Kentucky,M11,2006,5.2,105390,1939264,2044654
Kentucky,M10,2006,4.9,99171,1932510,2031681
Kentucky,M09,2006,5.3,108664,1922604,2031268
Kentucky,M08,2006,5.4,110602,1920004,2030606
Kentucky,M07,2006,6.0,122409,1923952,2046361
Kentucky,M06,2006,5.9,121645,1935796,2057441
Kentucky,M05,2006,5.6,113589,1913135,2026724
Kentucky,M04,2006,5.6,113610,1904758,2018368
Kentucky,M03,2006,6.2,126204,1893091,2019295
Kentucky,M02,2006,6.8,136460,1868972,2005432
Kentucky,M01,2006,6.5,129262,1865423,1994685
Kentucky,M12,2005,5.7,115074,1896817,2011891
Kentucky,M11,2005,5.8,116362,1898988,2015350
Kentucky,M10,2005,5.4,108758,1896452,2005210
Kentucky,M09,2005,5.4,108370,1893449,2001819
Kentucky,M08,2005,5.6,113234,1892387,2005621
Kentucky,M07,2005,6.1,123222,1896835,2020057
Kentucky,M06,2005,6.2,126327,1906013,2032340
Kentucky,M05,2005,5.9,117653,1886733,2004386
Kentucky,M04,2005,5.6,111497,1878424,1989921
Kentucky,M03,2005,6.2,123360,1859240,1982600
Kentucky,M02,2005,6.6,129779,1840267,1970046
Kentucky,M01,2005,6.1,120371,1837712,1958083
Kentucky,M12,2004,4.8,95055,1874377,1969432
Kentucky,M11,2004,4.7,92520,1879572,1972092
Kentucky,M10,2004,4.5,88507,1869929,1958436
Kentucky,M09,2004,4.6,90781,1865654,1956435
Kentucky,M08,2004,4.9,96805,1863328,1960133
Kentucky,M07,2004,5.6,110382,1870261,1980643
Kentucky,M06,2004,5.7,114423,1877594,1992017
Kentucky,M05,2004,5.5,107607,1857546,1965153
Kentucky,M04,2004,5.4,104955,1852779,1957734
Kentucky,M03,2004,6.3,122667,1838806,1961473
Kentucky,M02,2004,6.5,126039,1822146,1948185
Kentucky,M01,2004,6.3,122971,1821794,1944765
Kentucky,M12,2003,5.3,103992,1856703,1960695
Kentucky,M11,2003,5.6,111197,1859182,1970379
Kentucky,M10,2003,5.4,106312,1850115,1956427
Kentucky,M09,2003,5.7,112022,1846427,1958449
Kentucky,M08,2003,5.8,114247,1842163,1956410
Kentucky,M07,2003,6.5,127592,1847937,1975529
Kentucky,M06,2003,6.8,136397,1863547,1999944
Kentucky,M05,2003,6.2,122130,1842528,1964658
Kentucky,M04,2003,6.0,116885,1837636,1954521
Kentucky,M03,2003,6.5,127152,1823980,1951132
Kentucky,M02,2003,7.0,135454,1805089,1940543
Kentucky,M01,2003,6.7,128680,1803163,1931843
Kentucky,M12,2002,5.6,109174,1835757,1944931
Kentucky,M11,2002,5.5,106363,1838688,1945051
Kentucky,M10,2002,5.0,97487,1838941,1936428
Kentucky,M09,2002,5.2,100702,1841349,1942051
Kentucky,M08,2002,5.4,104202,1834028,1938230
Kentucky,M07,2002,5.6,109355,1843161,1952516
Kentucky,M06,2002,5.8,113680,1856402,1970082
Kentucky,M05,2002,5.5,106415,1840941,1947356
Kentucky,M04,2002,5.4,104429,1832738,1937167
Kentucky,M03,2002,6.2,120432,1825413,1945845
Kentucky,M02,2002,6.5,126021,1812443,1938464
Kentucky,M01,2002,6.6,127560,1802561,1930121
Kentucky,M12,2001,5.6,109868,1842930,1952798
Kentucky,M11,2001,5.6,108832,1846927,1955759
Kentucky,M10,2001,5.2,102213,1845457,1947670
Kentucky,M09,2001,4.9,96182,1849826,1946008
Kentucky,M08,2001,5.2,100606,1845064,1945670
Kentucky,M07,2001,5.2,102729,1868768,1971497
Kentucky,M06,2001,5.1,101051,1882196,1983247
Kentucky,M05,2001,4.7,91261,1867642,1958903
Kentucky,M04,2001,4.7,92865,1866439,1959304
Kentucky,M03,2001,5.3,103654,1865293,1968947
Kentucky,M02,2001,5.3,103444,1851585,1955029
Kentucky,M01,2001,5.2,101350,1854729,1956079
Kentucky,M12,2000,4.0,79282,1891900,1971182
Kentucky,M11,2000,4.1,80082,1890677,1970759
Kentucky,M10,2000,3.7,72421,1884883,1957304
Kentucky,M09,2000,3.8,73723,1880450,1954173
Kentucky,M08,2000,3.9,77023,1879746,1956769
Kentucky,M07,2000,4.2,83079,1890418,1973497
Kentucky,M06,2000,4.2,83395,1909507,1992902
Kentucky,M05,2000,4.1,79923,1888628,1968551
Kentucky,M04,2000,3.7,72123,1892142,1964265
Kentucky,M03,2000,4.6,89699,1879779,1969478
Kentucky,M02,2000,5.1,100547,1859953,1960500
Kentucky,M01,2000,4.7,92392,1856484,1948876
Maryland,M12,2016,3.9,122921,3049712,3172633
Maryland,M11,2016,4.0,126573,3054001,3180574
Maryland,M10,2016,4.2,133706,3053972,3187678
Maryland,M09,2016,4.2,132464,3045351,3177815
Maryland,M08,2016,4.4,139987,3051378,3191365
Maryland,M07,2016,4.4,142953,3076364,3219317
Maryland,M06,2016,4.5,142976,3047294,3190270
Maryland,M05,2016,4.0,125543,3026453,3151996
Maryland,M04,2016,4.0,126511,3016490,3143001
Maryland,M03,2016,4.4,139770,3012098,3151868
Maryland,M02,2016,4.7,147351,2991274,3138625
Maryland,M01,2016,4.8,149803,2985179,3134982
Maryland,M12,2015,4.4,138190,3005746,3143936
Maryland,M11,2015,4.7,146750,3004656,3151406
Maryland,M10,2015,4.8,151939,3004882,3156821
Maryland,M09,2015,4.8,150627,2990354,3140981
Maryland,M08,2015,5.1,160828,3002768,3163596
Maryland,M07,2015,5.3,169671,3029238,3198909
Maryland,M06,2015,5.4,170044,3008133,3178177
Maryland,M05,2015,5.1,162223,2988216,3150439
Maryland,M04,2015,4.8,151376,2971890,3123266
Maryland,M03,2015,5.4,167571,2957738,3125309
Maryland,M02,2015,5.6,175306,2940003,3115309
Maryland,M01,2015,5.9,182978,2938160,3121138
Maryland,M12,2014,5.2,161662,2959181,3120843
Maryland,M11,2014,5.4,169247,2964993,3134240
Maryland,M10,2014,5.4,171099,2968733,3139832
Maryland,M09,2014,5.5,172493,2952571,3125064
Maryland,M08,2014,6.0,189610,2957652,3147262
Maryland,M07,2014,6.2,196595,2982642,3179237
Maryland,M06,2014,6.1,191439,2961858,3153297
Maryland,M05,2014,5.8,179302,2937491,3116793
Maryland,M04,2014,5.4,168365,2924723,3093088
Maryland,M03,2014,6.1,189716,2917588,3107304
Maryland,M02,2014,6.3,195658,2897627,3093285
Maryland,M01,2014,6.3,195999,2897664,3093663
Maryland,M12,2013,5.8,178844,2919167,3098011
Maryland,M11,2013,6.1,188644,2926396,3115040
Maryland,M10,2013,6.5,203263,2922220,3125483
Maryland,M09,2013,6.3,195458,2926044,3121502
Maryland,M08,2013,6.5,205646,2935308,3140954
Maryland,M07,2013,6.8,215725,2963132,3178857
Maryland,M06,2013,7.1,224016,2940683,3164699
Maryland,M05,2013,6.6,207700,2921102,3128802
Maryland,M04,2013,6.4,198469,2910333,3108802
Maryland,M03,2013,6.8,212724,2902713,3115437
Maryland,M02,2013,7.1,222053,2888080,3110133
Maryland,M01,2013,7.4,230389,2887763,3118152
Maryland,M12,2012,6.7,209174,2913418,3122592
Maryland,M11,2012,6.6,207613,2917905,3125518
Maryland,M10,2012,6.7,211696,2925122,3136818
Maryland,M09,2012,6.7,209115,2913839,3122954
Maryland,M08,2012,7.1,222806,2912705,3135511
Maryland,M07,2012,7.3,231117,2938700,3169817
Maryland,M06,2012,7.3,231056,2918017,3149073
Maryland,M05,2012,6.8,212528,2896762,3109290
Maryland,M04,2012,6.5,201822,2885634,3087456
Maryland,M03,2012,7.0,216884,2882697,3099581
Maryland,M02,2012,7.4,227247,2863360,3090607
Maryland,M01,2012,7.4,227026,2859520,3086546
Maryland,M12,2011,6.8,210020,2885520,3095540
Maryland,M11,2011,6.8,209229,2889077,3098306
Maryland,M10,2011,7.0,218095,2889838,3107933
Maryland,M09,2011,7.2,223830,2878583,3102413
Maryland,M08,2011,7.4,231577,2885963,3117540
Maryland,M07,2011,7.5,234201,2908934,3143135
Maryland,M06,2011,7.6,237604,2883068,3120672
Maryland,M05,2011,7.1,219827,2867031,3086858
Maryland,M04,2011,6.9,212075,2859776,3071851
Maryland,M03,2011,7.3,223698,2854225,3077923
Maryland,M02,2011,7.6,234179,2831985,3066164
Maryland,M01,2011,7.8,239389,2831006,3070395
Maryland,M12,2010,7.2,222407,2854690,3077097
Maryland,M11,2010,7.4,229332,2857544,3086876
Maryland,M10,2010,7.3,224454,2861733,3086187
Maryland,M09,2010,7.4,229886,2856162,3086048
Maryland,M08,2010,7.7,240152,2866010,3106162
Maryland,M07,2010,7.8,245281,2885817,3131098
Maryland,M06,2010,7.7,238281,2859273,3097554
Maryland,M05,2010,7.4,227269,2839601,3066870
Maryland,M04,2010,7.3,224331,2828269,3052600
Maryland,M03,2010,8.1,246268,2803209,3049477
Maryland,M02,2010,8.3,250159,2770985,3021144
Maryland,M01,2010,8.1,246187,2778615,3024802
Maryland,M12,2009,7.3,221887,2801113,3023000
Maryland,M11,2009,7.2,219423,2815749,3035172
Maryland,M10,2009,7.2,219419,2816955,3036374
Maryland,M09,2009,7.1,214697,2812550,3027247
Maryland,M08,2009,7.2,218821,2833640,3052461
Maryland,M07,2009,7.2,223183,2864216,3087399
Maryland,M06,2009,7.3,223227,2839281,3062508
Maryland,M05,2009,6.9,208524,2819948,3028472
Maryland,M04,2009,6.5,194707,2816329,3011036
Maryland,M03,2009,6.8,204278,2810302,3014580
Maryland,M02,2009,6.8,205622,2800849,3006471
Maryland,M01,2009,6.5,195667,2812005,3007672
Maryland,M12,2008,5.4,162857,2850816,3013673
Maryland,M11,2008,5.0,152068,2867423,3019491
Maryland,M10,2008,4.8,144562,2879750,3024312
Maryland,M09,2008,4.5,135775,2873731,3009506
Maryland,M08,2008,4.6,138472,2891932,3030404
Maryland,M07,2008,4.4,135456,2923311,3058767
Maryland,M06,2008,4.3,130677,2897094,3027771
Maryland,M05,2008,3.8,113407,2877380,2990787
Maryland,M04,2008,3.2,96344,2873149,2969493
Maryland,M03,2008,3.4,102308,2865336,2967644
Maryland,M02,2008,3.5,104639,2846614,2951253
Maryland,M01,2008,3.6,107023,2853309,2960332
Maryland,M12,2007,3.1,93096,2874510,2967606
Maryland,M11,2007,3.1,93018,2882227,2975245
Maryland,M10,2007,3.3,96879,2878863,2975742
Maryland,M09,2007,3.3,99045,2873151,2972196
Maryland,M08,2007,3.4,102917,2884324,2987241
Maryland,M07,2007,3.7,112256,2913306,3025562
Maryland,M06,2007,3.7,111637,2884104,2995741
Maryland,M05,2007,3.3,97432,2857875,2955307
Maryland,M04,2007,3.2,93529,2846239,2939768
Maryland,M03,2007,3.4,101162,2850105,2951267
Maryland,M02,2007,3.8,112930,2827805,2940735
Maryland,M01,2007,4.0,119045,2835669,2954714
Maryland,M12,2006,3.5,103013,2865928,2968941
Maryland,M11,2006,3.6,108448,2866126,2974574
Maryland,M10,2006,3.6,108624,2868653,2977277
Maryland,M09,2006,3.8,112615,2856278,2968893
Maryland,M08,2006,4.1,122818,2870925,2993743
Maryland,M07,2006,4.3,130942,2894309,3025251
Maryland,M06,2006,4.3,128930,2867665,2996595
Maryland,M05,2006,3.9,115099,2840435,2955534
Maryland,M04,2006,3.6,105378,2829405,2934783
Maryland,M03,2006,3.7,107120,2826362,2933482
Maryland,M02,2006,4.0,116110,2803184,2919294
Maryland,M01,2006,3.9,115050,2802977,2918027
Maryland,M12,2005,3.5,103554,2825203,2928757
Maryland,M11,2005,3.8,112011,2825297,2937308
Maryland,M10,2005,3.8,112664,2829396,2942060
Maryland,M09,2005,3.9,113755,2818520,2932275
Maryland,M08,2005,4.0,119172,2834104,2953276
Maryland,M07,2005,4.3,128648,2854707,2983355
Maryland,M06,2005,4.5,132321,2819883,2952204
Maryland,M05,2005,4.1,120441,2793912,2914353
Maryland,M04,2005,4.0,114725,2779548,2894273
Maryland,M03,2005,4.4,127013,2766475,2893488
Maryland,M02,2005,4.7,135391,2746067,2881458
Maryland,M01,2005,4.6,133015,2748733,2881748
Maryland,M12,2004,4.0,116414,2775769,2892183
Maryland,M11,2004,4.1,118707,2780684,2899391
Maryland,M10,2004,4.0,115725,2782002,2897727
Maryland,M09,2004,4.0,114316,2771113,2885429
Maryland,M08,2004,4.2,123334,2789913,2913247
Maryland,M07,2004,4.5,131278,2813846,2945124
Maryland,M06,2004,4.6,132821,2779899,2912720
Maryland,M05,2004,4.1,117712,2755326,2873038
Maryland,M04,2004,3.9,112813,2745825,2858638
Maryland,M03,2004,4.4,125868,2743433,2869301
Maryland,M02,2004,4.6,130725,2727239,2857964
Maryland,M01,2004,4.7,134472,2732653,2867125
Maryland,M12,2003,4.1,116915,2756498,2873413
Maryland,M11,2003,4.2,121209,2761101,2882310
Maryland,M10,2003,4.1,119197,2763771,2882968
Maryland,M09,2003,4.2,120656,2755568,2876224
Maryland,M08,2003,4.4,126588,2778853,2905441
Maryland,M07,2003,4.6,135124,2803668,2938792
Maryland,M06,2003,4.9,142452,2775660,2918112
Maryland,M05,2003,4.4,125201,2749646,2874847
Maryland,M04,2003,4.2,121346,2740674,2862020
Maryland,M03,2003,4.6,132489,2732818,2865307
Maryland,M02,2003,4.8,136560,2715366,2851926
Maryland,M01,2003,4.7,134618,2720654,2855272
Maryland,M12,2002,4.2,119065,2742607,2861672
Maryland,M11,2002,4.3,122188,2746342,2868530
Maryland,M10,2002,4.0,116392,2757860,2874252
Maryland,M09,2002,4.0,115807,2754326,2870133
Maryland,M08,2002,4.4,125913,2762859,2888772
Maryland,M07,2002,4.5,130255,2781056,2911311
Maryland,M06,2002,4.7,136312,2760218,2896530
Maryland,M05,2002,4.3,123413,2739950,2863363
Maryland,M04,2002,4.4,126535,2726908,2853443
Maryland,M03,2002,4.6,132241,2726855,2859096
Maryland,M02,2002,4.8,137432,2710604,2848036
Maryland,M01,2002,5.1,143883,2700422,2844305
Maryland,M12,2001,4.3,122811,2728966,2851777
Maryland,M11,2001,4.5,127178,2728300,2855478
Maryland,M10,2001,4.4,124375,2731364,2855739
Maryland,M09,2001,4.2,118274,2721608,2839882
Maryland,M08,2001,4.2,120536,2728339,2848875
Maryland,M07,2001,4.1,116802,2761605,2878407
Maryland,M06,2001,4.0,115288,2740579,2855867
Maryland,M05,2001,3.6,100830,2719481,2820311
Maryland,M04,2001,3.5,96988,2711675,2808663
Maryland,M03,2001,3.7,103634,2716597,2820231
Maryland,M02,2001,3.9,108231,2699069,2807300
Maryland,M01,2001,3.9,110664,2702623,2813287
Maryland,M12,2000,3.3,92860,2730047,2822907
Maryland,M11,2000,3.5,97496,2723446,2820942
Maryland,M10,2000,3.4,97146,2722423,2819569
Maryland,M09,2000,3.5,98891,2709469,2808360
Maryland,M08,2000,3.8,106976,2707764,2814740
Maryland,M07,2000,3.8,108207,2737427,2845634
Maryland,M06,2000,3.9,109263,2720294,2829557
Maryland,M05,2000,3.6,100247,2693190,2793437
Maryland,M04,2000,3.2,89140,2689625,2778765
Maryland,M03,2000,3.5,98161,2682713,2780874
Maryland,M02,2000,3.8,105387,2660225,2765612
Maryland,M01,2000,3.7,101037,2662781,2763818
Montana,M12,2016,4.3,22261,500562,522823
Montana,M11,2016,3.8,19879,505044,524923
Montana,M10,2016,3.7,19296,507253,526549
Montana,M09,2016,3.4,17809,507884,525693
Montana,M08,2016,3.7,19672,514370,534042
Montana,M07,2016,3.8,20466,516649,537115
Montana,M06,2016,4.2,22468,511618,534086
Montana,M05,2016,3.7,19465,507295,526760
Montana,M04,2016,4.1,21382,502713,524095
Montana,M03,2016,4.9,25582,496615,522197
Montana,M02,2016,5.0,26156,493508,519664
Montana,M01,2016,5.3,27530,491366,518896
Montana,M12,2015,4.4,22598,496404,519002
Montana,M11,2015,4.1,21102,497921,519023
Montana,M10,2015,3.8,19535,500692,520227
Montana,M09,2015,3.4,17808,500848,518656
Montana,M08,2015,3.7,19365,508054,527419
Montana,M07,2015,3.8,20159,510240,530399
Montana,M06,2015,4.2,21889,504474,526363
Montana,M05,2015,3.6,18839,500310,519149
Montana,M04,2015,4.0,20534,496086,516620
Montana,M03,2015,4.8,24692,490285,514977
Montana,M02,2015,5.0,25407,487353,512760
Montana,M01,2015,5.3,26949,484436,511385
Montana,M12,2014,4.4,22494,486108,508602
Montana,M11,2014,4.5,22765,487620,510385
Montana,M10,2014,4.0,20559,491331,511890
Montana,M09,2014,3.8,19510,493530,513040
Montana,M08,2014,4.1,21473,500968,522441
Montana,M07,2014,4.2,22235,503402,525637
Montana,M06,2014,4.6,24020,496973,520993
Montana,M05,2014,4.2,21524,491898,513422
Montana,M04,2014,4.7,24017,486912,510929
Montana,M03,2014,5.7,28904,481105,510009
Montana,M02,2014,5.8,29457,479444,508901
Montana,M01,2014,6.1,30851,476866,507717
Montana,M12,2013,5.4,27348,481841,509189
Montana,M11,2013,5.1,26179,484551,510730
Montana,M10,2013,4.9,25032,486994,512026
Montana,M09,2013,4.5,23084,488310,511394
Montana,M08,2013,4.8,25134,494739,519873
Montana,M07,2013,5.0,26073,495882,521955
Montana,M06,2013,5.5,28480,491140,519620
Montana,M05,2013,4.9,25270,487185,512455
Montana,M04,2013,5.5,27911,482011,509922
Montana,M03,2013,6.3,31900,475980,507880
Montana,M02,2013,6.4,32649,473743,506392
Montana,M01,2013,6.8,34132,471295,505427
Montana,M12,2012,5.8,29178,474316,503494
Montana,M11,2012,5.5,27881,476711,504592
Montana,M10,2012,5.3,26724,480411,507135
Montana,M09,2012,5.1,25714,481813,507527
Montana,M08,2012,5.4,27774,487985,515759
Montana,M07,2012,5.5,28705,489437,518142
Montana,M06,2012,6.1,31229,482830,514059
Montana,M05,2012,5.6,28374,478203,506577
Montana,M04,2012,6.1,30805,472145,502950
Montana,M03,2012,7.0,35043,465812,500855
Montana,M02,2012,7.1,35601,462834,498435
Montana,M01,2012,7.4,36699,461587,498286
Montana,M12,2011,6.5,32577,465264,497841
Montana,M11,2011,6.3,31461,467975,499436
Montana,M10,2011,6.1,30665,470489,501154
Montana,M09,2011,6.0,30049,472166,502215
Montana,M08,2011,6.3,32111,477731,509842
Montana,M07,2011,6.5,32954,477409,510363
Montana,M06,2011,7.0,35497,471955,507452
Montana,M05,2011,6.6,32955,467848,500803
Montana,M04,2011,7.2,35882,463050,498932
Montana,M03,2011,8.1,40445,456590,497035
Montana,M02,2011,8.3,40898,453895,494793
Montana,M01,2011,8.6,42374,452466,494840
Montana,M12,2010,7.6,37457,457738,495195
Montana,M11,2010,7.1,35148,460829,495977
Montana,M10,2010,6.6,32750,465359,498109
Montana,M09,2010,6.4,31849,467949,499798
Montana,M08,2010,6.5,33335,475626,508961
Montana,M07,2010,6.7,34310,477350,511660
Montana,M06,2010,7.2,36649,471325,507974
Montana,M05,2010,6.8,34223,467249,501472
Montana,M04,2010,7.5,37548,462632,500180
Montana,M03,2010,8.4,41568,455915,497483
Montana,M02,2010,8.4,41746,453320,495066
Montana,M01,2010,8.4,41740,452688,494428
Montana,M12,2009,7.4,36556,458257,494813
Montana,M11,2009,6.7,33342,462835,496177
Montana,M10,2009,6.2,30939,465742,496681
Montana,M09,2009,6.0,29982,467751,497733
Montana,M08,2009,6.2,31313,476031,507344
Montana,M07,2009,6.2,31842,478648,510490
Montana,M06,2009,6.7,34267,474102,508369
Montana,M05,2009,6.4,32221,469044,501265
Montana,M04,2009,7.0,34858,466075,500933
Montana,M03,2009,7.9,39333,459467,498800
Montana,M02,2009,7.7,38382,460743,499125
Montana,M01,2009,7.7,38574,461865,500439
Montana,M12,2008,6.2,31308,471785,503093
Montana,M11,2008,5.7,28866,477311,506177
Montana,M10,2008,5.1,26147,482058,508205
Montana,M09,2008,4.7,24189,485157,509346
Montana,M08,2008,4.7,24551,494002,518553
Montana,M07,2008,4.6,23922,496243,520165
Montana,M06,2008,5.0,25559,490631,516190
Montana,M05,2008,4.3,22048,487718,509766
Montana,M04,2008,4.7,24035,483425,507460
Montana,M03,2008,5.3,26583,478974,505557
Montana,M02,2008,5.3,26440,477081,503521
Montana,M01,2008,5.2,26144,475780,501924
Montana,M12,2007,4.2,21304,480558,501862
Montana,M11,2007,3.9,19765,483325,503090
Montana,M10,2007,3.6,17984,486043,504027
Montana,M09,2007,3.3,16809,486622,503431
Montana,M08,2007,3.4,17443,495154,512597
Montana,M07,2007,3.4,17341,496967,514308
Montana,M06,2007,3.6,18416,491511,509927
Montana,M05,2007,2.9,14643,486547,501190
Montana,M04,2007,3.2,15888,482300,498188
Montana,M03,2007,3.6,17713,477114,494827
Montana,M02,2007,3.7,18172,472999,491171
Montana,M01,2007,3.9,19099,471124,490223
Montana,M12,2006,3.1,15259,474785,490044
Montana,M11,2006,3.0,14694,475569,490263
Montana,M10,2006,2.7,13496,477653,491149
Montana,M09,2006,2.7,13253,478856,492109
Montana,M08,2006,3.0,15167,487874,503041
Montana,M07,2006,3.1,15950,492452,508402
Montana,M06,2006,3.6,18361,486137,504498
Montana,M05,2006,3.2,15825,478875,494700
Montana,M04,2006,3.7,18416,473663,492079
Montana,M03,2006,4.4,21486,466457,487943
Montana,M02,2006,4.5,21898,463535,485433
Montana,M01,2006,4.8,23033,460670,483703
Montana,M12,2005,4.1,19994,464238,484232
Montana,M11,2005,3.8,18679,467323,486002
Montana,M10,2005,3.6,17585,469308,486893
Montana,M09,2005,3.6,17441,469944,487385
Montana,M08,2005,3.8,19066,476318,495384
Montana,M07,2005,4.0,19753,477315,497068
Montana,M06,2005,4.5,22115,470495,492610
Montana,M05,2005,4.0,19283,465338,484621
Montana,M04,2005,4.5,21702,460976,482678
Montana,M03,2005,5.2,25113,455665,480778
Montana,M02,2005,5.4,25624,452533,478157
Montana,M01,2005,5.7,27410,449432,476842
Montana,M12,2004,4.6,21816,455847,477663
Montana,M11,2004,4.4,21097,458075,479172
Montana,M10,2004,4.2,20046,459951,479997
Montana,M09,2004,4.1,19656,461449,481105
Montana,M08,2004,4.3,20951,468376,489327
Montana,M07,2004,4.3,21172,470977,492149
Montana,M06,2004,4.8,23653,465319,488972
Montana,M05,2004,4.3,20770,460305,481075
Montana,M04,2004,4.8,23050,456606,479656
Montana,M03,2004,5.7,26803,447381,474184
Montana,M02,2004,5.7,26960,443696,470656
Montana,M01,2004,6.0,28322,441099,469421
Montana,M12,2003,5.0,23386,446176,469562
Montana,M11,2003,4.8,22471,448290,470761
Montana,M10,2003,4.3,20216,451572,471788
Montana,M09,2003,4.1,19306,452545,471851
Montana,M08,2003,4.3,20551,459644,480195
Montana,M07,2003,4.2,20394,459840,480234
Montana,M06,2003,4.7,22633,454458,477091
Montana,M05,2003,4.1,19416,451758,471174
Montana,M04,2003,4.7,22200,447837,470037
Montana,M03,2003,5.5,25472,440827,466299
Montana,M02,2003,5.3,24698,439748,464446
Montana,M01,2003,5.6,25938,438501,464439
Montana,M12,2002,4.6,21341,443874,465215
Montana,M11,2002,4.4,20308,445762,466070
Montana,M10,2002,3.8,17754,448527,466281
Montana,M09,2002,3.5,16411,450226,466637
Montana,M08,2002,3.7,17320,456474,473794
Montana,M07,2002,3.8,18139,458439,476578
Montana,M06,2002,4.4,20735,453932,474667
Montana,M05,2002,3.9,18040,448763,466803
Montana,M04,2002,4.6,21508,443836,465344
Montana,M03,2002,5.5,25323,437857,463180
Montana,M02,2002,5.3,24435,436766,461201
Montana,M01,2002,5.5,25443,435220,460663
Montana,M12,2001,4.6,21228,438853,460081
Montana,M11,2001,4.4,20138,441539,461677
Montana,M10,2001,3.9,18004,444806,462810
Montana,M09,2001,3.7,17214,445743,462957
Montana,M08,2001,3.9,18505,453985,472490
Montana,M07,2001,3.9,18546,456176,474722
Montana,M06,2001,4.5,21230,452669,473899
Montana,M05,2001,4.1,18990,448432,467422
Montana,M04,2001,4.8,22155,444173,466328
Montana,M03,2001,5.5,25404,439310,464714
Montana,M02,2001,5.5,25580,437419,462999
Montana,M01,2001,5.8,26858,435797,462655
Montana,M12,2000,4.8,22302,437745,460047
Montana,M11,2000,4.7,21955,440832,462787
Montana,M10,2000,4.3,19875,443849,463724
Montana,M09,2000,4.2,19460,446846,466306
Montana,M08,2000,4.4,20914,454495,475409
Montana,M07,2000,4.4,20937,455999,476936
Montana,M06,2000,4.9,23205,451055,474260
Montana,M05,2000,4.5,21077,447766,468843
Montana,M04,2000,5.1,23699,443552,467251
Montana,M03,2000,5.9,27404,439135,466539
Montana,M02,2000,6.0,27897,435418,463315
Montana,M01,2000,6.3,29146,432954,462100
District of Columbia,M12,2016,5.5,21456,371309,392765
District of Columbia,M11,2016,5.7,22343,372111,394454
District of Columbia,M10,2016,5.9,23389,371315,394704
District of Columbia,M09,2016,6.2,24088,366845,390933
District of Columbia,M08,2016,6.4,24968,366300,391268
District of Columbia,M07,2016,6.3,25186,372221,397407
District of Columbia,M06,2016,6.3,24938,369713,394651
District of Columbia,M05,2016,5.4,21042,367742,388784
District of Columbia,M04,2016,5.4,21130,370091,391221
District of Columbia,M03,2016,6.0,23501,367823,391324
District of Columbia,M02,2016,6.5,25650,366817,392467
District of Columbia,M01,2016,6.6,25527,363869,389396
District of Columbia,M12,2015,6.2,24094,364971,389065
District of Columbia,M11,2015,6.5,25271,364253,389524
District of Columbia,M10,2015,6.6,25891,363787,389678
District of Columbia,M09,2015,6.8,26201,359921,386122
District of Columbia,M08,2015,7.0,27172,360660,387832
District of Columbia,M07,2015,7.0,27685,366043,393728
District of Columbia,M06,2015,7.1,27440,360950,388390
District of Columbia,M05,2015,6.5,24832,356737,381569
District of Columbia,M04,2015,6.5,24887,357721,382608
District of Columbia,M03,2015,7.1,27023,355854,382877
District of Columbia,M02,2015,7.7,29493,355935,385428
District of Columbia,M01,2015,7.8,29805,353871,383676
District of Columbia,M12,2014,7.3,28011,353562,381573
District of Columbia,M11,2014,7.6,28955,354087,383042
District of Columbia,M10,2014,7.7,29702,353903,383605
District of Columbia,M09,2014,8.0,30298,350213,380511
District of Columbia,M08,2014,8.2,30983,348092,379075
District of Columbia,M07,2014,8.1,30983,353065,384048
District of Columbia,M06,2014,7.9,30098,349482,379580
District of Columbia,M05,2014,7.2,26917,344856,371773
District of Columbia,M04,2014,7.2,26644,344413,371057
District of Columbia,M03,2014,7.8,28964,342313,371277
District of Columbia,M02,2014,8.2,30611,342317,372928
District of Columbia,M01,2014,8.1,30071,340380,370451
District of Columbia,M12,2013,7.6,28350,343079,371429
District of Columbia,M11,2013,8.0,29761,342739,372500
District of Columbia,M10,2013,8.7,32305,339783,372088
District of Columbia,M09,2013,8.6,31944,338600,370544
District of Columbia,M08,2013,8.7,32434,339774,372208
District of Columbia,M07,2013,8.7,33128,346385,379513
District of Columbia,M06,2013,8.8,33338,343414,376752
District of Columbia,M05,2013,8.2,30414,341332,371746
District of Columbia,M04,2013,8.0,29999,343085,373084
District of Columbia,M03,2013,8.6,31996,341402,373398
District of Columbia,M02,2013,9.0,33690,342007,375697
District of Columbia,M01,2013,9.1,34065,339693,373758
District of Columbia,M12,2012,8.6,32096,341095,373191
District of Columbia,M11,2012,8.6,32272,341190,373462
District of Columbia,M10,2012,8.7,32514,340006,372520
District of Columbia,M09,2012,8.9,32794,335540,368334
District of Columbia,M08,2012,9.0,33100,334847,367947
District of Columbia,M07,2012,9.0,33553,338754,372307
District of Columbia,M06,2012,9.2,33689,334483,368172
District of Columbia,M05,2012,8.6,31050,328662,359712
District of Columbia,M04,2012,8.6,30738,326437,357175
District of Columbia,M03,2012,9.4,33430,323727,357157
District of Columbia,M02,2012,9.9,35270,321606,356876
District of Columbia,M01,2012,10.1,35548,317458,353006
District of Columbia,M12,2011,9.7,33969,316638,350607
District of Columbia,M11,2011,10.0,34859,315271,350130
District of Columbia,M10,2011,10.1,35453,314309,349762
District of Columbia,M09,2011,10.4,36263,314026,350289
District of Columbia,M08,2011,10.5,36842,314808,351650
District of Columbia,M07,2011,10.7,38302,319754,358056
District of Columbia,M06,2011,10.9,38385,315351,353736
District of Columbia,M05,2011,10.1,35172,311950,347122
District of Columbia,M04,2011,9.6,33547,315231,348778
District of Columbia,M03,2011,10.0,34823,314707,349530
District of Columbia,M02,2011,10.0,35071,316220,351291
District of Columbia,M01,2011,9.9,34596,313781,348377
District of Columbia,M12,2010,9.3,32052,313559,345611
District of Columbia,M11,2010,9.4,32607,313564,346171
District of Columbia,M10,2010,9.4,32363,313276,345639
District of Columbia,M09,2010,9.4,32301,312543,344844
District of Columbia,M08,2010,9.4,32420,313663,346083
District of Columbia,M07,2010,9.4,33641,322602,356243
District of Columbia,M06,2010,9.5,33596,319186,352782
District of Columbia,M05,2010,8.9,30902,315702,346604
District of Columbia,M04,2010,8.7,29934,314431,344365
District of Columbia,M03,2010,9.5,32620,309896,342516
District of Columbia,M02,2010,9.9,33674,307708,341382
District of Columbia,M01,2010,10.2,34575,305965,340540
District of Columbia,M12,2009,9.8,33218,306076,339294
District of Columbia,M11,2009,10.0,34114,305347,339461
District of Columbia,M10,2009,10.1,34201,303317,337518
District of Columbia,M09,2009,10.1,33749,301241,334990
District of Columbia,M08,2009,9.8,33145,306136,339281
District of Columbia,M07,2009,9.6,33098,311807,344905
District of Columbia,M06,2009,9.6,32348,305495,337843
District of Columbia,M05,2009,8.8,29240,301226,330466
District of Columbia,M04,2009,8.2,26866,301573,328439
District of Columbia,M03,2009,8.5,28061,302751,330812
District of Columbia,M02,2009,8.5,28335,305088,333423
District of Columbia,M01,2009,8.3,27690,303939,331629
District of Columbia,M12,2008,7.7,25403,304845,330248
District of Columbia,M11,2008,7.5,24813,305822,330635
District of Columbia,M10,2008,7.1,23462,306764,330226
District of Columbia,M09,2008,6.8,22720,309123,331843
District of Columbia,M08,2008,6.5,21930,313388,335318
District of Columbia,M07,2008,6.6,22231,317143,339374
District of Columbia,M06,2008,6.5,21575,311947,333522
District of Columbia,M05,2008,5.8,18846,308705,327551
District of Columbia,M04,2008,5.2,17089,309674,326763
District of Columbia,M03,2008,5.8,19018,308946,327964
District of Columbia,M02,2008,5.9,19338,308465,327803
District of Columbia,M01,2008,6.1,19793,305487,325280
District of Columbia,M12,2007,5.5,17832,307129,324961
District of Columbia,M11,2007,5.6,18146,307227,325373
District of Columbia,M10,2007,5.6,18067,306144,324211
District of Columbia,M09,2007,5.7,18291,303682,321973
District of Columbia,M08,2007,5.5,17901,304973,322874
District of Columbia,M07,2007,5.7,18810,309467,328277
District of Columbia,M06,2007,5.8,18847,305102,323949
District of Columbia,M05,2007,5.1,16348,302061,318409
District of Columbia,M04,2007,4.8,15298,303346,318644
District of Columbia,M03,2007,5.4,17246,302964,320210
District of Columbia,M02,2007,5.7,18172,302490,320662
District of Columbia,M01,2007,5.9,18768,298530,317298
District of Columbia,M12,2006,5.5,17506,299597,317103
District of Columbia,M11,2006,5.7,18152,299582,317734
District of Columbia,M10,2006,5.8,18272,299019,317291
District of Columbia,M09,2006,6.0,18835,297177,316012
District of Columbia,M08,2006,5.9,18734,299591,318325
District of Columbia,M07,2006,6.1,19814,304814,324628
District of Columbia,M06,2006,6.2,19727,300987,320714
District of Columbia,M05,2006,5.6,17413,295076,312489
District of Columbia,M04,2006,5.2,16257,294581,310838
District of Columbia,M03,2006,5.7,17941,294753,312694
District of Columbia,M02,2006,5.9,18396,295174,313570
District of Columbia,M01,2006,5.9,18517,293082,311599
District of Columbia,M12,2005,5.5,17292,294947,312239
District of Columbia,M11,2005,5.7,17990,295064,313054
District of Columbia,M10,2005,5.7,17909,295016,312925
District of Columbia,M09,2005,5.8,18131,295276,313407
District of Columbia,M08,2005,5.8,18443,298576,317019
District of Columbia,M07,2005,6.3,20295,302735,323030
District of Columbia,M06,2005,6.8,21661,297511,319172
District of Columbia,M05,2005,6.5,20228,293135,313363
District of Columbia,M04,2005,6.2,19497,294359,313856
District of Columbia,M03,2005,7.0,22083,293578,315661
District of Columbia,M02,2005,7.4,23485,294112,317597
District of Columbia,M01,2005,7.8,24565,291504,316069
District of Columbia,M12,2004,7.7,24363,290982,315345
District of Columbia,M11,2004,8.1,25717,290679,316396
District of Columbia,M10,2004,8.2,26019,289691,315710
District of Columbia,M09,2004,8.3,26003,287865,313868
District of Columbia,M08,2004,8.2,25830,289648,315478
District of Columbia,M07,2004,8.4,26841,292337,319178
District of Columbia,M06,2004,8.3,25978,288185,314163
District of Columbia,M05,2004,7.4,22835,284130,306965
District of Columbia,M04,2004,6.9,21267,285675,306942
District of Columbia,M03,2004,7.4,22810,285059,307869
District of Columbia,M02,2004,7.3,22420,285490,307910
District of Columbia,M01,2004,7.2,22042,282450,304492
District of Columbia,M12,2003,6.6,19963,283536,303499
District of Columbia,M11,2003,6.8,20829,284279,305108
District of Columbia,M10,2003,6.8,20982,285486,306468
District of Columbia,M09,2003,6.8,20942,285262,306204
District of Columbia,M08,2003,7.0,21690,286904,308594
District of Columbia,M07,2003,7.2,22909,293338,316247
District of Columbia,M06,2003,7.4,23069,289098,312167
District of Columbia,M05,2003,6.5,19820,284890,304710
District of Columbia,M04,2003,6.2,18896,285191,304087
District of Columbia,M03,2003,6.8,20570,283890,304460
District of Columbia,M02,2003,7.0,21258,282874,304132
District of Columbia,M01,2003,6.9,20682,280700,301382
District of Columbia,M12,2002,6.3,19012,282867,301879
District of Columbia,M11,2002,6.3,19172,283208,302380
District of Columbia,M10,2002,6.3,18985,283469,302454
District of Columbia,M09,2002,6.3,19146,284484,303630
District of Columbia,M08,2002,6.3,19446,288508,307954
District of Columbia,M07,2002,6.6,20780,294294,315074
District of Columbia,M06,2002,6.7,20691,289594,310285
District of Columbia,M05,2002,6.1,18671,285880,304551
District of Columbia,M04,2002,5.8,17606,287868,305474
District of Columbia,M03,2002,6.5,19870,286751,306621
District of Columbia,M02,2002,6.8,20843,286591,307434
District of Columbia,M01,2002,6.9,21011,284435,305446
District of Columbia,M12,2001,6.2,19026,286261,305287
District of Columbia,M11,2001,6.6,20288,287370,307658
District of Columbia,M10,2001,6.5,20253,289688,309941
District of Columbia,M09,2001,6.6,20541,289506,310047
District of Columbia,M08,2001,6.6,20790,293954,314744
District of Columbia,M07,2001,6.7,21418,298174,319592
District of Columbia,M06,2001,6.8,21423,293502,314925
District of Columbia,M05,2001,5.8,17839,289760,307599
District of Columbia,M04,2001,5.4,16421,290231,306652
District of Columbia,M03,2001,6.1,18943,290110,309053
District of Columbia,M02,2001,6.3,19618,290667,310285
District of Columbia,M01,2001,6.4,19883,290511,310394
District of Columbia,M12,2000,5.7,17984,295736,313720
District of Columbia,M11,2000,5.9,18386,295662,314048
District of Columbia,M10,2000,5.9,18352,294125,312477
District of Columbia,M09,2000,5.9,18330,292399,310729
District of Columbia,M08,2000,5.7,17766,295394,313160
District of Columbia,M07,2000,5.8,18356,299555,317911
District of Columbia,M06,2000,5.6,17577,294854,312431
District of Columbia,M05,2000,5.0,15193,289773,304966
District of Columbia,M04,2000,4.7,14224,291587,305811
District of Columbia,M03,2000,5.5,16737,290130,306867
District of Columbia,M02,2000,5.7,17613,290115,307728
District of Columbia,M01,2000,5.9,18074,287701,305775
Michigan,M12,2016,4.5,215298,4615387,4830685
Michigan,M11,2016,4.2,203410,4642568,4845978
Michigan,M10,2016,4.8,234794,4634194,4868988
Michigan,M09,2016,4.8,233070,4627804,4860874
Michigan,M08,2016,5.2,254249,4620035,4874284
Michigan,M07,2016,5.8,282996,4608817,4891813
Michigan,M06,2016,5.2,251290,4625843,4877133
Michigan,M05,2016,4.5,218781,4615579,4834360
Michigan,M04,2016,4.5,217050,4569502,4786552
Michigan,M03,2016,5.3,256851,4568347,4825198
Michigan,M02,2016,5.1,242852,4551164,4794016
Michigan,M01,2016,5.1,241886,4509351,4751237
Michigan,M12,2015,4.4,210115,4548666,4758781
Michigan,M11,2015,4.3,204635,4555473,4760108
Michigan,M10,2015,4.7,224743,4539364,4764107
Michigan,M09,2015,4.6,215607,4514349,4729956
Michigan,M08,2015,5.2,250553,4522641,4773194
Michigan,M07,2015,6.3,304750,4503465,4808215
Michigan,M06,2015,5.9,283112,4528213,4811325
Michigan,M05,2015,5.8,280457,4523114,4803571
Michigan,M04,2015,5.1,240120,4466995,4707115
Michigan,M03,2015,5.9,277671,4448867,4726538
Michigan,M02,2015,6.1,286191,4437019,4723210
Michigan,M01,2015,6.6,311556,4411807,4723363
Michigan,M12,2014,5.6,261815,4452571,4714386
Michigan,M11,2014,5.8,273436,4470990,4744426
Michigan,M10,2014,6.3,299042,4468572,4767614
Michigan,M09,2014,6.5,309060,4437191,4746251
Michigan,M08,2014,7.3,350351,4428470,4778821
Michigan,M07,2014,8.4,407794,4422189,4829983
Michigan,M06,2014,7.6,365975,4447493,4813468
Michigan,M05,2014,7.5,359772,4418303,4778075
Michigan,M04,2014,7.0,327362,4366061,4693423
Michigan,M03,2014,8.3,397244,4361437,4758681
Michigan,M02,2014,8.5,400276,4332843,4733119
Michigan,M01,2014,8.4,392183,4299476,4691659
Michigan,M12,2013,7.6,354817,4334336,4689153
Michigan,M11,2013,7.7,362458,4351527,4713985
Michigan,M10,2013,8.4,395287,4321352,4716639
Michigan,M09,2013,8.3,393186,4350022,4743208
Michigan,M08,2013,9.0,427883,4339437,4767320
Michigan,M07,2013,10.2,489337,4328933,4818270
Michigan,M06,2013,9.6,463865,4352272,4816137
Michigan,M05,2013,8.8,417996,4341460,4759456
Michigan,M04,2013,8.1,377681,4284218,4661899
Michigan,M03,2013,9.0,421041,4260436,4681477
Michigan,M02,2013,9.4,440303,4244033,4684336
Michigan,M01,2013,10.0,467307,4212234,4679541
Michigan,M12,2012,8.7,405704,4271748,4677452
Michigan,M11,2012,7.9,368544,4287440,4655984
Michigan,M10,2012,8.5,397268,4298541,4695809
Michigan,M09,2012,8.3,388960,4277209,4666169
Michigan,M08,2012,9.5,443982,4252511,4696493
Michigan,M07,2012,10.6,504181,4244127,4748308
Michigan,M06,2012,9.8,462289,4274337,4736626
Michigan,M05,2012,9.1,425751,4264930,4690681
Michigan,M04,2012,8.3,383784,4218386,4602170
Michigan,M03,2012,9.4,437873,4211343,4649216
Michigan,M02,2012,9.6,445792,4193476,4639268
Michigan,M01,2012,9.7,448321,4165849,4614170
Michigan,M12,2011,9.0,419187,4239837,4659024
Michigan,M11,2011,8.5,398000,4263302,4661302
Michigan,M10,2011,9.4,441705,4251512,4693217
Michigan,M09,2011,10.0,467642,4226299,4693941
Michigan,M08,2011,10.6,502344,4222185,4724529
Michigan,M07,2011,11.8,560613,4185817,4746430
Michigan,M06,2011,11.2,529518,4210477,4739995
Michigan,M05,2011,10.5,494221,4205600,4699821
Michigan,M04,2011,10.0,462476,4167494,4629970
Michigan,M03,2011,11.0,513231,4158211,4671442
Michigan,M02,2011,11.1,517444,4134711,4652155
Michigan,M01,2011,11.5,535400,4114740,4650140
Michigan,M12,2010,10.9,510025,4180671,4690696
Michigan,M11,2010,10.9,514760,4199171,4713931
Michigan,M10,2010,11.1,525886,4214423,4740309
Michigan,M09,2010,11.5,546577,4216401,4762978
Michigan,M08,2010,12.3,591624,4230406,4822030
Michigan,M07,2010,13.5,657000,4211245,4868245
Michigan,M06,2010,12.7,618159,4242846,4861005
Michigan,M05,2010,12.6,609496,4232459,4841955
Michigan,M04,2010,12.9,621440,4203495,4824935
Michigan,M03,2010,14.1,682910,4149661,4832571
Michigan,M02,2010,14.2,686936,4135999,4822935
Michigan,M01,2010,14.4,694137,4111710,4805847
Michigan,M12,2009,13.5,650755,4166546,4817301
Michigan,M11,2009,13.1,636937,4217858,4854795
Michigan,M10,2009,13.6,660921,4211279,4872200
Michigan,M09,2009,13.7,666586,4204641,4871227
Michigan,M08,2009,14.1,697456,4246559,4944015
Michigan,M07,2009,15.4,770692,4242011,5012703
Michigan,M06,2009,15.3,768639,4265921,5034560
Michigan,M05,2009,14.2,702416,4260347,4962763
Michigan,M04,2009,12.8,623239,4253965,4877204
Michigan,M03,2009,13.3,651300,4235698,4886998
Michigan,M02,2009,12.8,621595,4252762,4874357
Michigan,M01,2009,12.1,586351,4248051,4834402
Michigan,M12,2008,9.2,447675,4412014,4859689
Michigan,M11,2008,8.2,398313,4472518,4870831
Michigan,M10,2008,8.0,394583,4514038,4908621
Michigan,M09,2008,7.9,385331,4510065,4895396
Michigan,M08,2008,8.3,408942,4543149,4952091
Michigan,M07,2008,8.9,446669,4550765,4997434
Michigan,M06,2008,8.1,402243,4594522,4996765
Michigan,M05,2008,7.8,384489,4566688,4951177
Michigan,M04,2008,6.7,326460,4547853,4874313
Michigan,M03,2008,7.6,371951,4549473,4921424
Michigan,M02,2008,7.4,362378,4542097,4904475
Michigan,M01,2008,7.7,377084,4548280,4925364
Michigan,M12,2007,7.1,354672,4623106,4977778
Michigan,M11,2007,6.5,322844,4666588,4989432
Michigan,M10,2007,6.7,332559,4655004,4987563
Michigan,M09,2007,6.8,337190,4655840,4993030
Michigan,M08,2007,6.9,346637,4670145,5016782
Michigan,M07,2007,8.0,405166,4677954,5083120
Michigan,M06,2007,7.2,366937,4706352,5073289
Michigan,M05,2007,6.7,334264,4681169,5015433
Michigan,M04,2007,6.6,326628,4636815,4963443
Michigan,M03,2007,7.0,353108,4661955,5015063
Michigan,M02,2007,7.2,359864,4645384,5005248
Michigan,M01,2007,7.7,386297,4626952,5013249
Michigan,M12,2006,6.7,337484,4732473,5069957
Michigan,M11,2006,6.4,324066,4739440,5063506
Michigan,M10,2006,6.3,317776,4750074,5067850
Michigan,M09,2006,6.7,339071,4715006,5054077
Michigan,M08,2006,7.0,358086,4745301,5103387
Michigan,M07,2006,8.1,417905,4726305,5144210
Michigan,M06,2006,7.1,365913,4768390,5134303
Michigan,M05,2006,6.8,348163,4739346,5087509
Michigan,M04,2006,6.8,343211,4698827,5042038
Michigan,M03,2006,7.4,373565,4693324,5066889
Michigan,M02,2006,7.5,380125,4678937,5059062
Michigan,M01,2006,7.2,361486,4665593,5027079
Michigan,M12,2005,6.4,325958,4750044,5076002
Michigan,M11,2005,6.3,319334,4769461,5088795
Michigan,M10,2005,5.8,295505,4792434,5087939
Michigan,M09,2005,6.2,316086,4766062,5082148
Michigan,M08,2005,6.2,317395,4801101,5118496
Michigan,M07,2005,7.4,380217,4773709,5153926
Michigan,M06,2005,6.9,355852,4785401,5141253
Michigan,M05,2005,6.7,339637,4760195,5099832
Michigan,M04,2005,6.6,335036,4706104,5041140
Michigan,M03,2005,7.5,377498,4673024,5050522
Michigan,M02,2005,7.8,391665,4656936,5048601
Michigan,M01,2005,7.5,376553,4632351,5008904
Michigan,M12,2004,7.0,353460,4716710,5070170
Michigan,M11,2004,6.7,342250,4746279,5088529
Michigan,M10,2004,6.5,327611,4747530,5075141
Michigan,M09,2004,6.5,327581,4722059,5049640
Michigan,M08,2004,6.7,340086,4749571,5089657
Michigan,M07,2004,8.0,409868,4726354,5136222
Michigan,M06,2004,7.4,379370,4740745,5120115
Michigan,M05,2004,6.8,344477,4712755,5057232
Michigan,M04,2004,6.4,318453,4669502,4987955
Michigan,M03,2004,7.8,393130,4651773,5044903
Michigan,M02,2004,7.4,369275,4652841,5022116
Michigan,M01,2004,7.5,375863,4630977,5006840
Michigan,M12,2003,6.4,320292,4699058,5019350
Michigan,M11,2003,6.3,317392,4713853,5031245
Michigan,M10,2003,6.5,326384,4706346,5032730
Michigan,M09,2003,6.9,345761,4668742,5014503
Michigan,M08,2003,7.1,360185,4686536,5046721
Michigan,M07,2003,8.3,419732,4663007,5082739
Michigan,M06,2003,8.0,411194,4705383,5116577
Michigan,M05,2003,7.2,361863,4670063,5031926
Michigan,M04,2003,7.0,349823,4631399,4981222
Michigan,M03,2003,7.6,379856,4627237,5007093
Michigan,M02,2003,7.4,372434,4627832,5000266
Michigan,M01,2003,7.3,364161,4605780,4969941
Michigan,M12,2002,6.1,306836,4683931,4990767
Michigan,M11,2002,5.7,282803,4699730,4982533
Michigan,M10,2002,5.2,261859,4736318,4998177
Michigan,M09,2002,5.3,266248,4730243,4996491
Michigan,M08,2002,5.8,292442,4732781,5025223
Michigan,M07,2002,7.0,357226,4711153,5068379
Michigan,M06,2002,6.7,341598,4738142,5079740
Michigan,M05,2002,6.1,306532,4718109,5024641
Michigan,M04,2002,6.2,307336,4670226,4977562
Michigan,M03,2002,7.1,358131,4677809,5035940
Michigan,M02,2002,6.7,337731,4689469,5027200
Michigan,M01,2002,7.2,358158,4640881,4999039
Michigan,M12,2001,6.0,304654,4756458,5061112
Michigan,M11,2001,5.7,287043,4781472,5068515
Michigan,M10,2001,5.1,259226,4815822,5075048
Michigan,M09,2001,4.8,242395,4827741,5070136
Michigan,M08,2001,5.1,258346,4848921,5107267
Michigan,M07,2001,5.5,283569,4885317,5168886
Michigan,M06,2001,5.1,266101,4911818,5177919
Michigan,M05,2001,4.6,235787,4898401,5134188
Michigan,M04,2001,4.6,233331,4871075,5104406
Michigan,M03,2001,5.4,277526,4894426,5171952
Michigan,M02,2001,5.1,261040,4889336,5150376
Michigan,M01,2001,5.3,274891,4874776,5149667
Michigan,M12,2000,3.7,192053,4989768,5181821
Michigan,M11,2000,3.4,176710,4979867,5156577
Michigan,M10,2000,3.1,157381,4980574,5137955
Michigan,M09,2000,3.4,173867,4949657,5123524
Michigan,M08,2000,3.7,193610,4982716,5176326
Michigan,M07,2000,4.6,238399,4976068,5214467
Michigan,M06,2000,3.8,200618,5025024,5225642
Michigan,M05,2000,3.4,173681,4986696,5160377
Michigan,M04,2000,2.9,149895,4980987,5130882
Michigan,M03,2000,3.8,197859,4966711,5164570
Michigan,M02,2000,3.7,189195,4962882,5152077
Michigan,M01,2000,3.8,194160,4934915,5129075
Puerto Rico,M12,2016,12.0,136773,1002225,1138998
Puerto Rico,M11,2016,11.0,121705,989363,1111068
Puerto Rico,M10,2016,12.5,137831,964899,1102730
Puerto Rico,M09,2016,13.1,146222,972925,1119147
Puerto Rico,M08,2016,12.0,133047,973718,1106765
Puerto Rico,M07,2016,12.5,140449,984749,1125198
Puerto Rico,M06,2016,10.8,119781,988611,1108392
Puerto Rico,M05,2016,11.3,127305,1003547,1130852
Puerto Rico,M04,2016,11.3,127927,999521,1127448
Puerto Rico,M03,2016,12.2,137705,989277,1126982
Puerto Rico,M02,2016,11.6,131565,1002230,1133795
Puerto Rico,M01,2016,11.2,125139,996905,1122044
Puerto Rico,M12,2015,10.3,117829,1022253,1140082
Puerto Rico,M11,2015,11.7,131969,994868,1126837
Puerto Rico,M10,2015,14.1,161397,980713,1142110
Puerto Rico,M09,2015,12.2,136521,985775,1122296
Puerto Rico,M08,2015,12.4,137328,973245,1110573
Puerto Rico,M07,2015,11.2,123076,980507,1103583
Puerto Rico,M06,2015,12.6,140095,970469,1110564
Puerto Rico,M05,2015,12.3,136198,966649,1102847
Puerto Rico,M04,2015,12.6,140447,973060,1113507
Puerto Rico,M03,2015,12.5,142282,993664,1135946
Puerto Rico,M02,2015,11.2,126545,1000627,1127172
Puerto Rico,M01,2015,10.8,122366,1009897,1132263
Puerto Rico,M12,2014,12.1,136051,992502,1128553
Puerto Rico,M11,2014,13.6,154028,978078,1132106
Puerto Rico,M10,2014,13.7,154479,971779,1126258
Puerto Rico,M09,2014,15.1,168769,949567,1118336
Puerto Rico,M08,2014,15.3,173624,958682,1132306
Puerto Rico,M07,2014,13.9,156586,966155,1122741
Puerto Rico,M06,2014,12.8,144367,979405,1123772
Puerto Rico,M05,2014,13.7,153979,972982,1126961
Puerto Rico,M04,2014,13.4,152160,979377,1131537
Puerto Rico,M03,2014,14.2,162490,983093,1145583
Puerto Rico,M02,2014,14.6,168255,984869,1153124
Puerto Rico,M01,2014,14.4,168897,1001067,1169964
Puerto Rico,M12,2013,15.4,180453,992861,1173314
Puerto Rico,M11,2013,14.1,164170,1004041,1168211
Puerto Rico,M10,2013,14.7,171363,992893,1164256
Puerto Rico,M09,2013,15.1,175232,984591,1159823
Puerto Rico,M08,2013,14.9,174162,990978,1165140
Puerto Rico,M07,2013,14.7,171505,997631,1169136
Puerto Rico,M06,2013,13.8,160478,999791,1160269
Puerto Rico,M05,2013,13.5,155952,997740,1153692
Puerto Rico,M04,2013,13.0,149646,998744,1148390
Puerto Rico,M03,2013,13.5,156450,1003984,1160434
Puerto Rico,M02,2013,13.9,162959,1012427,1175386
Puerto Rico,M01,2013,14.9,178884,1018679,1197563
Puerto Rico,M12,2012,13.6,162049,1026308,1188357
Puerto Rico,M11,2012,13.5,159892,1025311,1185203
Puerto Rico,M10,2012,14.5,171498,1013086,1184584
Puerto Rico,M09,2012,14.3,168175,1009668,1177843
Puerto Rico,M08,2012,14.4,170495,1011437,1181932
Puerto Rico,M07,2012,15.1,182333,1022746,1205079
Puerto Rico,M06,2012,14.2,169662,1028870,1198532
Puerto Rico,M05,2012,13.7,163681,1030775,1194456
Puerto Rico,M04,2012,14.5,172403,1013178,1185581
Puerto Rico,M03,2012,15.1,181560,1019073,1200633
Puerto Rico,M02,2012,15.2,183415,1026179,1209594
Puerto Rico,M01,2012,15.5,189585,1030018,1219603
Puerto Rico,M12,2011,13.4,163741,1053875,1217616
Puerto Rico,M11,2011,15.4,187576,1027353,1214929
Puerto Rico,M10,2011,16.5,201097,1017332,1218429
Puerto Rico,M09,2011,15.6,188157,1021544,1209701
Puerto Rico,M08,2011,16.4,196707,999324,1196031
Puerto Rico,M07,2011,16.5,200208,1011574,1211782
Puerto Rico,M06,2011,15.4,188473,1036497,1224970
Puerto Rico,M05,2011,16.3,198651,1018534,1217185
Puerto Rico,M04,2011,16.5,201961,1019110,1221071
Puerto Rico,M03,2011,17.1,210441,1019756,1230197
Puerto Rico,M02,2011,16.3,199954,1028866,1228820
Puerto Rico,M01,2011,15.9,199193,1052927,1252120
Puerto Rico,M12,2010,14.9,185427,1061762,1247189
Puerto Rico,M11,2010,15.6,198086,1069329,1267415
Puerto Rico,M10,2010,16.0,203599,1066591,1270190
Puerto Rico,M09,2010,16.5,208826,1056724,1265550
Puerto Rico,M08,2010,16.4,205507,1047600,1253107
Puerto Rico,M07,2010,17.3,217224,1041370,1258594
Puerto Rico,M06,2010,16.9,215460,1056463,1271923
Puerto Rico,M05,2010,17.1,217890,1053104,1270994
Puerto Rico,M04,2010,17.2,220762,1060329,1281091
Puerto Rico,M03,2010,16.3,207028,1065647,1272675
Puerto Rico,M02,2010,16.1,204413,1069131,1273544
Puerto Rico,M01,2010,16.0,207181,1084518,1291699
Puerto Rico,M12,2009,14.5,185470,1095941,1281411
Puerto Rico,M11,2009,15.8,203535,1087970,1291505
Puerto Rico,M10,2009,16.2,210305,1090182,1300487
Puerto Rico,M09,2009,16.8,217214,1077075,1294289
Puerto Rico,M08,2009,16.2,208197,1078904,1287101
Puerto Rico,M07,2009,16.8,219351,1083333,1302684
Puerto Rico,M06,2009,15.5,200822,1093570,1294392
Puerto Rico,M05,2009,14.6,191934,1118716,1310650
Puerto Rico,M04,2009,15.0,197212,1115980,1313192
Puerto Rico,M03,2009,14.9,193479,1102470,1295949
Puerto Rico,M02,2009,14.4,190022,1130878,1320900
Puerto Rico,M01,2009,13.3,175272,1147327,1322599
Puerto Rico,M12,2008,13.3,179608,1166364,1345972
Puerto Rico,M11,2008,12.7,171861,1177992,1349853
Puerto Rico,M10,2008,12.9,172478,1159764,1332242
Puerto Rico,M09,2008,12.2,163428,1172805,1336233
Puerto Rico,M08,2008,12.8,172147,1168172,1340319
Puerto Rico,M07,2008,12.4,166567,1173081,1339648
Puerto Rico,M06,2008,12.1,163357,1191162,1354519
Puerto Rico,M05,2008,11.6,157269,1199225,1356494
Puerto Rico,M04,2008,10.1,134755,1205889,1340644
Puerto Rico,M03,2008,9.3,125768,1220803,1346571
Puerto Rico,M02,2008,10.8,146669,1212775,1359444
Puerto Rico,M01,2008,11.0,148392,1200748,1349140
Puerto Rico,M12,2007,10.8,145821,1201206,1347027
Puerto Rico,M11,2007,11.1,150905,1204551,1355456
Puerto Rico,M10,2007,12.3,166338,1188011,1354349
Puerto Rico,M09,2007,11.3,153265,1201940,1355205
Puerto Rico,M08,2007,12.2,167728,1202224,1369952
Puerto Rico,M07,2007,12.3,168759,1207291,1376050
Puerto Rico,M06,2007,12.0,166750,1222827,1389577
Puerto Rico,M05,2007,10.8,151419,1245250,1396669
Puerto Rico,M04,2007,10.1,141645,1265197,1406842
Puerto Rico,M03,2007,10.2,145870,1281742,1427612
Puerto Rico,M02,2007,10.9,158104,1291515,1449619
Puerto Rico,M01,2007,10.2,144510,1275436,1419946
Puerto Rico,M12,2006,9.7,137497,1275070,1412567
Puerto Rico,M11,2006,9.9,140175,1280007,1420182
Puerto Rico,M10,2006,9.8,137981,1273320,1411301
Puerto Rico,M09,2006,11.0,156174,1263466,1419640
Puerto Rico,M08,2006,10.9,152996,1250737,1403733
Puerto Rico,M07,2006,11.9,166531,1235276,1401807
Puerto Rico,M06,2006,11.5,164550,1265910,1430460
Puerto Rico,M05,2006,11.3,162254,1270035,1432289
Puerto Rico,M04,2006,9.8,141999,1300683,1442682
Puerto Rico,M03,2006,9.3,132978,1296882,1429860
Puerto Rico,M02,2006,9.9,140210,1271530,1411740
Puerto Rico,M01,2006,11.0,156823,1265401,1422224
Puerto Rico,M12,2005,10.8,148653,1230136,1378789
Puerto Rico,M11,2005,12.6,175785,1221044,1396829
Puerto Rico,M10,2005,12.5,173498,1212921,1386419
Puerto Rico,M09,2005,10.6,149934,1257910,1407844
Puerto Rico,M08,2005,11.2,156534,1237991,1394525
Puerto Rico,M07,2005,11.9,165718,1222870,1388588
Puerto Rico,M06,2005,11.8,166625,1247586,1414211
Puerto Rico,M05,2005,10.9,150748,1230166,1380914
Puerto Rico,M04,2005,11.4,153175,1192991,1346166
Puerto Rico,M03,2005,11.4,155000,1205142,1360142
Puerto Rico,M02,2005,10.0,133810,1202458,1336268
Puerto Rico,M01,2005,10.8,145443,1200601,1346044
Puerto Rico,M12,2004,9.8,133261,1222719,1355980
Puerto Rico,M11,2004,9.9,133695,1212336,1346031
Puerto Rico,M10,2004,10.1,136674,1211546,1348220
Puerto Rico,M09,2004,9.8,132195,1223548,1355743
Puerto Rico,M08,2004,11.4,154872,1201732,1356604
Puerto Rico,M07,2004,10.0,134291,1202776,1337067
Puerto Rico,M06,2004,10.3,139610,1218259,1357869
Puerto Rico,M05,2004,10.8,144819,1196320,1341139
Puerto Rico,M04,2004,11.0,147684,1199547,1347231
Puerto Rico,M03,2004,11.7,159033,1197825,1356858
Puerto Rico,M02,2004,10.8,143345,1185598,1328943
Puerto Rico,M01,2004,11.3,150669,1182217,1332886
Puerto Rico,M12,2003,10.1,135041,1207140,1342181
Puerto Rico,M11,2003,12.0,161122,1177685,1338807
Puerto Rico,M10,2003,11.7,155574,1176208,1331782
Puerto Rico,M09,2003,12.2,160325,1152352,1312677
Puerto Rico,M08,2003,12.2,162601,1168072,1330673
Puerto Rico,M07,2003,12.4,167167,1183651,1350818
Puerto Rico,M06,2003,12.7,175041,1200175,1375216
Puerto Rico,M05,2003,12.0,165655,1209710,1375365
Puerto Rico,M04,2003,12.3,168077,1196640,1364717
Puerto Rico,M03,2003,12.1,163756,1187744,1351500
Puerto Rico,M02,2003,12.5,168094,1173773,1341867
Puerto Rico,M01,2003,11.4,151864,1181919,1333783
Puerto Rico,M12,2002,10.9,143426,1167446,1310872
Puerto Rico,M11,2002,11.0,145044,1177431,1322475
Puerto Rico,M10,2002,12.0,157645,1154124,1311769
Puerto Rico,M09,2002,12.6,165820,1154154,1319974
Puerto Rico,M08,2002,13.1,173878,1149321,1323199
Puerto Rico,M07,2002,12.9,169539,1147396,1316935
Puerto Rico,M06,2002,12.9,173263,1168908,1342171
Puerto Rico,M05,2002,12.2,161513,1162196,1323709
Puerto Rico,M04,2002,12.0,158832,1162243,1321075
Puerto Rico,M03,2002,12.3,163023,1164214,1327237
Puerto Rico,M02,2002,13.7,183770,1159856,1343626
Puerto Rico,M01,2002,11.4,147226,1146175,1293401
Puerto Rico,M12,2001,9.7,125051,1161054,1286105
Puerto Rico,M11,2001,11.1,143623,1152512,1296135
Puerto Rico,M10,2001,12.7,161560,1115448,1277008
Puerto Rico,M09,2001,12.6,160944,1115215,1276159
Puerto Rico,M08,2001,12.8,163167,1107027,1270194
Puerto Rico,M07,2001,10.8,135528,1114067,1249595
Puerto Rico,M06,2001,11.4,146039,1135818,1281857
Puerto Rico,M05,2001,11.4,145458,1131437,1276895
Puerto Rico,M04,2001,11.2,142170,1124197,1266367
Puerto Rico,M03,2001,10.7,135655,1127824,1263479
Puerto Rico,M02,2001,11.4,145998,1130413,1276411
Puerto Rico,M01,2001,10.4,131222,1129439,1260661
Puerto Rico,M12,2000,8.9,114426,1166130,1280556
Puerto Rico,M11,2000,8.9,114038,1160344,1274382
Puerto Rico,M10,2000,10.1,127720,1138016,1265736
Puerto Rico,M09,2000,9.7,123815,1146273,1270088
Puerto Rico,M08,2000,11.2,143362,1131883,1275245
Puerto Rico,M07,2000,10.0,129775,1170012,1299787
Puerto Rico,M06,2000,10.1,132625,1174864,1307489
Puerto Rico,M05,2000,10.0,133038,1197782,1330820
Puerto Rico,M04,2000,10.0,129204,1159253,1288457
Puerto Rico,M03,2000,10.4,136164,1178597,1314761
Puerto Rico,M02,2000,10.5,135846,1162588,1298434
Puerto Rico,M01,2000,11.7,151512,1146656,1298168
Hawaii,M12,2016,2.6,17691,673778,691469
Hawaii,M11,2016,2.9,19950,672152,692102
Hawaii,M10,2016,2.9,20269,667157,687426
Hawaii,M09,2016,3.1,21042,664414,685456
Hawaii,M08,2016,2.9,19978,666696,686674
Hawaii,M07,2016,3.1,21439,668267,689706
Hawaii,M06,2016,3.6,24984,661637,686621
Hawaii,M05,2016,3.0,20261,660757,681018
Hawaii,M04,2016,3.0,20394,661399,681793
Hawaii,M03,2016,3.0,20494,661108,681602
Hawaii,M02,2016,3.0,20426,659505,679931
Hawaii,M01,2016,3.1,21331,659409,680740
Hawaii,M12,2015,2.8,19180,660604,679784
Hawaii,M11,2015,3.2,22004,657294,679298
Hawaii,M10,2015,3.3,22144,651682,673826
Hawaii,M09,2015,3.6,24176,648963,673139
Hawaii,M08,2015,3.4,23022,652837,675859
Hawaii,M07,2015,3.5,23478,654793,678271
Hawaii,M06,2015,4.1,28025,649563,677588
Hawaii,M05,2015,3.6,24150,648814,672964
Hawaii,M04,2015,3.6,24322,648877,673199
Hawaii,M03,2015,3.8,25441,646751,672192
Hawaii,M02,2015,3.9,26042,644470,670512
Hawaii,M01,2015,4.1,27732,644559,672291
Hawaii,M12,2014,3.7,24949,644559,669508
Hawaii,M11,2014,4.1,27587,643146,670733
Hawaii,M10,2014,4.1,27404,638220,665624
Hawaii,M09,2014,4.3,28621,636057,664678
Hawaii,M08,2014,4.2,28019,639413,667432
Hawaii,M07,2014,4.4,29695,642020,671715
Hawaii,M06,2014,5.0,33648,636437,670085
Hawaii,M05,2014,4.3,28759,635543,664302
Hawaii,M04,2014,4.4,29072,635585,664657
Hawaii,M03,2014,4.5,29638,633165,662803
Hawaii,M02,2014,4.6,30386,629846,660232
Hawaii,M01,2014,4.7,31399,629821,661220
Hawaii,M12,2013,4.4,29016,629848,658864
Hawaii,M11,2013,4.8,31784,626252,658036
Hawaii,M10,2013,5.0,32440,619770,652210
Hawaii,M09,2013,5.0,32288,617130,649418
Hawaii,M08,2013,4.7,30342,619250,649592
Hawaii,M07,2013,4.8,31428,622198,653626
Hawaii,M06,2013,5.4,34892,616402,651294
Hawaii,M05,2013,4.6,29997,615427,645424
Hawaii,M04,2013,4.7,30218,615005,645223
Hawaii,M03,2013,4.8,31209,613150,644359
Hawaii,M02,2013,4.9,31800,611201,643001
Hawaii,M01,2013,5.2,33218,610329,643547
Hawaii,M12,2012,4.8,30993,613192,644185
Hawaii,M11,2012,5.3,34218,611961,646179
Hawaii,M10,2012,5.5,35258,606835,642093
Hawaii,M09,2012,5.7,36744,604684,641428
Hawaii,M08,2012,5.7,36604,608688,645292
Hawaii,M07,2012,6.1,39484,610695,650179
Hawaii,M06,2012,6.8,44161,606224,650385
Hawaii,M05,2012,6.1,39603,607111,646714
Hawaii,M04,2012,6.2,40409,608761,649170
Hawaii,M03,2012,6.5,42426,607877,650303
Hawaii,M02,2012,6.5,42506,606709,649215
Hawaii,M01,2012,6.8,44190,606886,651076
Hawaii,M12,2011,6.4,41854,611538,653392
Hawaii,M11,2011,6.9,45413,611406,656819
Hawaii,M10,2011,6.9,45430,608629,654059
Hawaii,M09,2011,7.1,46277,608844,655121
Hawaii,M08,2011,6.9,45324,615018,660342
Hawaii,M07,2011,6.9,46126,620531,666657
Hawaii,M06,2011,7.4,49021,617100,666121
Hawaii,M05,2011,6.7,44107,618347,662454
Hawaii,M04,2011,6.5,42815,620891,663706
Hawaii,M03,2011,6.6,43533,619946,663479
Hawaii,M02,2011,6.7,44008,616676,660684
Hawaii,M01,2011,6.9,45301,614905,660206
Hawaii,M12,2010,6.4,41825,615119,656944
Hawaii,M11,2010,6.9,45655,612088,657743
Hawaii,M10,2010,6.9,44937,605602,650539
Hawaii,M09,2010,7.1,46189,602999,649188
Hawaii,M08,2010,7.0,45427,606854,652281
Hawaii,M07,2010,7.1,46816,609933,656749
Hawaii,M06,2010,7.5,48808,603196,652004
Hawaii,M05,2010,6.7,43268,601184,644452
Hawaii,M04,2010,6.7,43308,600085,643393
Hawaii,M03,2010,6.9,44035,593681,637716
Hawaii,M02,2010,6.9,43761,589161,632922
Hawaii,M01,2010,7.2,45573,587486,633059
Hawaii,M12,2009,6.8,43038,586435,629473
Hawaii,M11,2009,7.2,45503,584229,629732
Hawaii,M10,2009,7.2,45288,580759,626047
Hawaii,M09,2009,7.6,47637,579840,627477
Hawaii,M08,2009,7.3,45815,585934,631749
Hawaii,M07,2009,7.4,47083,591039,638122
Hawaii,M06,2009,7.9,49992,586759,636751
Hawaii,M05,2009,7.2,45639,586220,631859
Hawaii,M04,2009,7.1,44703,589106,633809
Hawaii,M03,2009,7.0,44273,587744,632017
Hawaii,M02,2009,6.7,42283,588432,630715
Hawaii,M01,2009,6.4,40758,591771,632529
Hawaii,M12,2008,5.6,35513,597234,632747
Hawaii,M11,2008,5.6,35547,600367,635914
Hawaii,M10,2008,5.1,32453,599616,632069
Hawaii,M09,2008,5.1,32203,602044,634247
Hawaii,M08,2008,4.5,28936,611775,640711
Hawaii,M07,2008,4.4,28813,619164,647977
Hawaii,M06,2008,4.7,30428,617317,647745
Hawaii,M05,2008,3.7,23808,618992,642800
Hawaii,M04,2008,3.5,22584,621487,644071
Hawaii,M03,2008,3.2,20264,620689,640953
Hawaii,M02,2008,3.1,19874,618395,638269
Hawaii,M01,2008,3.2,20428,618361,638789
Hawaii,M12,2007,2.9,18492,619071,637563
Hawaii,M11,2007,3.1,19711,616992,636703
Hawaii,M10,2007,2.9,18424,612982,631406
Hawaii,M09,2007,3.1,19648,612205,631853
Hawaii,M08,2007,2.8,17767,617637,635404
Hawaii,M07,2007,2.9,18843,623964,642807
Hawaii,M06,2007,3.3,21197,622228,643425
Hawaii,M05,2007,2.5,16011,622419,638430
Hawaii,M04,2007,2.5,15941,624440,640381
Hawaii,M03,2007,2.6,16600,625165,641765
Hawaii,M02,2007,2.4,15506,624150,639656
Hawaii,M01,2007,2.5,16176,625168,641344
Hawaii,M12,2006,1.9,12359,628365,640724
Hawaii,M11,2006,2.4,15180,627018,642198
Hawaii,M10,2006,2.3,14817,621394,636211
Hawaii,M09,2006,2.6,16586,619880,636466
Hawaii,M08,2006,2.5,15851,624263,640114
Hawaii,M07,2006,2.9,18419,626499,644918
Hawaii,M06,2006,3.4,21928,620777,642705
Hawaii,M05,2006,2.7,17391,618821,636212
Hawaii,M04,2006,2.7,17493,620148,637641
Hawaii,M03,2006,2.8,17625,618563,636188
Hawaii,M02,2006,2.5,16126,616777,632903
Hawaii,M01,2006,2.6,16472,616376,632848
Hawaii,M12,2005,2.3,14729,618484,633213
Hawaii,M11,2005,2.8,18028,615679,633707
Hawaii,M10,2005,2.8,17504,611693,629197
Hawaii,M09,2005,3.0,19139,609315,628454
Hawaii,M08,2005,2.8,17612,613849,631461
Hawaii,M07,2005,2.9,18713,615761,634474
Hawaii,M06,2005,3.4,21303,608572,629875
Hawaii,M05,2005,2.7,16693,606456,623149
Hawaii,M04,2005,2.7,16982,607029,624011
Hawaii,M03,2005,2.8,17607,602887,620494
Hawaii,M02,2005,2.9,18024,599630,617654
Hawaii,M01,2005,3.1,19127,598129,617256
Hawaii,M12,2004,2.8,16989,599044,616033
Hawaii,M11,2004,3.3,20222,596867,617089
Hawaii,M10,2004,3.2,19842,590764,610606
Hawaii,M09,2004,3.4,20955,587573,608528
Hawaii,M08,2004,3.2,19770,592952,612722
Hawaii,M07,2004,3.3,20621,596666,617287
Hawaii,M06,2004,3.9,23884,590268,614152
Hawaii,M05,2004,3.2,19593,588778,608371
Hawaii,M04,2004,3.3,20277,589122,609399
Hawaii,M03,2004,3.6,22038,585164,607202
Hawaii,M02,2004,3.6,21584,582483,604067
Hawaii,M01,2004,3.8,23291,582189,605480
Hawaii,M12,2003,3.6,21762,582751,604513
Hawaii,M11,2003,4.1,25077,579752,604829
Hawaii,M10,2003,4.2,25075,574718,599793
Hawaii,M09,2003,4.6,27399,572694,600093
Hawaii,M08,2003,4.2,25322,578324,603646
Hawaii,M07,2003,4.4,26648,582793,609441
Hawaii,M06,2003,5.0,30107,577732,607839
Hawaii,M05,2003,4.0,24021,577591,601612
Hawaii,M04,2003,3.9,23565,579493,603058
Hawaii,M03,2003,3.8,23032,578359,601391
Hawaii,M02,2003,3.7,21967,577657,599624
Hawaii,M01,2003,3.9,23617,578011,601628
Hawaii,M12,2002,3.2,19351,578620,597971
Hawaii,M11,2002,3.9,23161,575767,598928
Hawaii,M10,2002,3.8,22621,572116,594737
Hawaii,M09,2002,4.2,24796,570989,595785
Hawaii,M08,2002,3.9,23362,576016,599378
Hawaii,M07,2002,4.2,25376,580450,605826
Hawaii,M06,2002,4.7,28533,576619,605152
Hawaii,M05,2002,4.2,25028,575337,600365
Hawaii,M04,2002,4.3,25556,575538,601094
Hawaii,M03,2002,4.5,27042,575493,602535
Hawaii,M02,2002,4.6,28010,575113,603123
Hawaii,M01,2002,5.1,31123,575073,606196
Hawaii,M12,2001,4.9,29854,577545,607399
Hawaii,M11,2001,5.6,34125,576535,610660
Hawaii,M10,2001,5.3,31993,573552,605545
Hawaii,M09,2001,4.4,26660,579809,606469
Hawaii,M08,2001,4.1,25069,584947,610016
Hawaii,M07,2001,4.4,27127,590250,617377
Hawaii,M06,2001,4.9,29935,585680,615615
Hawaii,M05,2001,4.1,24809,585363,610172
Hawaii,M04,2001,4.3,26209,587930,614139
Hawaii,M03,2001,4.0,24297,587500,611797
Hawaii,M02,2001,4.0,24237,585337,609574
Hawaii,M01,2001,4.1,24999,583790,608789
Hawaii,M12,2000,3.6,22016,585804,607820
Hawaii,M11,2000,4.0,24160,582930,607090
Hawaii,M10,2000,4.0,23957,577763,601720
Hawaii,M09,2000,4.3,25872,575151,601023
Hawaii,M08,2000,4.2,25414,579455,604869
Hawaii,M07,2000,4.3,26510,584114,610624
Hawaii,M06,2000,4.8,29214,580583,609797
Hawaii,M05,2000,4.2,25201,579928,605129
Hawaii,M04,2000,4.2,25236,582299,607535
Hawaii,M03,2000,4.3,25825,580081,605906
Hawaii,M02,2000,4.4,26821,577478,604299
Hawaii,M01,2000,4.7,28571,576979,605550
Idaho,M12,2016,3.5,28961,787417,816378
Idaho,M11,2016,3.7,30103,788159,818262
Idaho,M10,2016,3.3,26793,793154,819947
Idaho,M09,2016,3.4,27770,790032,817802
Idaho,M08,2016,3.7,30223,791381,821604
Idaho,M07,2016,3.6,30081,797719,827800
Idaho,M06,2016,3.7,30153,794442,824595
Idaho,M05,2016,3.4,27316,785522,812838
Idaho,M04,2016,3.9,31401,776209,807610
Idaho,M03,2016,4.4,35407,770664,806071
Idaho,M02,2016,4.6,36623,766337,802960
Idaho,M01,2016,4.9,38813,760173,798986
Idaho,M12,2015,4.1,33062,767158,800220
Idaho,M11,2015,4.1,32638,767122,799760
Idaho,M10,2015,3.6,29120,773071,802191
Idaho,M09,2015,3.7,29994,770085,800079
Idaho,M08,2015,4.0,32134,771379,803513
Idaho,M07,2015,4.0,32595,778120,810715
Idaho,M06,2015,4.0,32657,775725,808382
Idaho,M05,2015,3.8,30592,766799,797391
Idaho,M04,2015,4.3,34115,755666,789781
Idaho,M03,2015,4.7,36979,749848,786827
Idaho,M02,2015,5.0,39153,745316,784469
Idaho,M01,2015,5.2,40728,740540,781268
Idaho,M12,2014,4.3,33949,746823,780772
Idaho,M11,2014,4.5,35470,746646,782116
Idaho,M10,2014,4.0,31351,752890,784241
Idaho,M09,2014,4.2,32683,748325,781008
Idaho,M08,2014,4.7,36684,750442,787126
Idaho,M07,2014,4.6,36528,756704,793232
Idaho,M06,2014,4.6,36283,754949,791232
Idaho,M05,2014,4.5,34809,745488,780297
Idaho,M04,2014,5.0,38793,735968,774761
Idaho,M03,2014,5.7,44001,729991,773992
Idaho,M02,2014,6.0,46128,725964,772092
Idaho,M01,2014,6.2,47917,721681,769598
Idaho,M12,2013,5.3,41153,728694,769847
Idaho,M11,2013,5.6,43465,729982,773447
Idaho,M10,2013,5.3,40914,734174,775088
Idaho,M09,2013,5.4,41772,730521,772293
Idaho,M08,2013,5.8,44794,731501,776295
Idaho,M07,2013,5.9,45960,737282,783242
Idaho,M06,2013,5.9,46212,735482,781694
Idaho,M05,2013,5.8,44519,726839,771358
Idaho,M04,2013,6.6,50540,716220,766760
Idaho,M03,2013,7.1,54244,710968,765212
Idaho,M02,2013,7.5,57097,707901,764998
Idaho,M01,2013,7.7,58795,703679,762474
Idaho,M12,2012,6.8,52088,714245,766333
Idaho,M11,2012,6.8,51869,716465,768334
Idaho,M10,2012,6.2,48049,723317,771366
Idaho,M09,2012,6.3,48562,720394,768956
Idaho,M08,2012,6.7,52019,720681,772700
Idaho,M07,2012,6.8,52681,726504,779185
Idaho,M06,2012,6.9,53714,725096,778810
Idaho,M05,2012,6.8,52386,716907,769293
Idaho,M04,2012,7.6,58145,706257,764402
Idaho,M03,2012,8.3,63204,701930,765134
Idaho,M02,2012,8.6,65948,698363,764311
Idaho,M01,2012,8.9,67956,694291,762247
Idaho,M12,2011,7.9,60763,705748,766511
Idaho,M11,2011,7.9,60309,706392,766701
Idaho,M10,2011,7.2,55325,711895,767220
Idaho,M09,2011,7.4,56416,709277,765693
Idaho,M08,2011,7.8,59955,710019,769974
Idaho,M07,2011,7.8,60580,714469,775049
Idaho,M06,2011,7.9,61392,710957,772349
Idaho,M05,2011,7.9,60007,702483,762490
Idaho,M04,2011,8.8,66845,693782,760627
Idaho,M03,2011,9.6,72642,687219,759861
Idaho,M02,2011,9.8,74226,684633,758859
Idaho,M01,2011,10.1,76081,680714,756795
Idaho,M12,2010,9.0,67850,689525,757375
Idaho,M11,2010,8.7,65952,692106,758058
Idaho,M10,2010,8.1,61375,699570,760945
Idaho,M09,2010,8.0,61009,697655,758664
Idaho,M08,2010,8.4,64538,700876,765414
Idaho,M07,2010,8.3,63850,706038,769888
Idaho,M06,2010,8.5,65265,704028,769293
Idaho,M05,2010,8.3,63489,698528,762017
Idaho,M04,2010,9.4,71342,689721,761063
Idaho,M03,2010,10.0,76154,682452,758606
Idaho,M02,2010,10.4,78518,678687,757205
Idaho,M01,2010,10.5,79423,674721,754144
Idaho,M12,2009,9.6,72689,684185,756874
Idaho,M11,2009,9.0,68445,687990,756435
Idaho,M10,2009,8.5,64720,694439,759159
Idaho,M09,2009,8.6,65144,692024,757168
Idaho,M08,2009,8.8,67480,695696,763176
Idaho,M07,2009,8.9,68290,702544,770834
Idaho,M06,2009,9.1,70624,701893,772517
Idaho,M05,2009,8.7,66444,693106,759550
Idaho,M04,2009,7.6,56151,686121,742272
Idaho,M03,2009,8.8,65677,682519,748196
Idaho,M02,2009,8.8,65806,683710,749516
Idaho,M01,2009,8.7,65438,684435,749873
Idaho,M12,2008,7.0,52449,698168,750617
Idaho,M11,2008,6.5,49074,703921,752995
Idaho,M10,2008,5.4,41161,716161,757322
Idaho,M09,2008,5.1,38747,718910,757657
Idaho,M08,2008,5.2,39995,724935,764930
Idaho,M07,2008,5.0,38962,733641,772603
Idaho,M06,2008,5.0,38212,731585,769797
Idaho,M05,2008,4.7,35411,723860,759271
Idaho,M04,2008,5.1,38183,715757,753940
Idaho,M03,2008,3.9,29253,712343,741596
Idaho,M02,2008,4.0,29895,710987,740882
Idaho,M01,2008,4.1,30657,709563,740220
Idaho,M12,2007,3.7,27604,722392,749996
Idaho,M11,2007,3.0,22813,727991,750804
Idaho,M10,2007,2.5,18910,735020,753930
Idaho,M09,2007,2.4,17998,736698,754696
Idaho,M08,2007,2.6,19834,741323,761157
Idaho,M07,2007,2.5,18822,748339,767161
Idaho,M06,2007,2.4,18275,747371,765646
Idaho,M05,2007,2.2,16951,737286,754237
Idaho,M04,2007,3.2,23815,726279,750094
Idaho,M03,2007,3.8,28200,721621,749821
Idaho,M02,2007,4.2,31541,717195,748736
Idaho,M01,2007,4.5,33667,713308,746975
Idaho,M12,2006,3.4,25339,722567,747906
Idaho,M11,2006,3.0,22753,723786,746539
Idaho,M10,2006,2.5,18517,730392,748909
Idaho,M09,2006,2.5,18506,727705,746211
Idaho,M08,2006,3.0,22350,731145,753495
Idaho,M07,2006,2.9,21662,735808,757470
Idaho,M06,2006,3.0,22310,733444,755754
Idaho,M05,2006,2.9,21274,723578,744852
Idaho,M04,2006,3.9,29146,713797,742943
Idaho,M03,2006,4.6,34151,708382,742533
Idaho,M02,2006,5.0,36904,704918,741822
Idaho,M01,2006,5.3,39460,700627,740087
Idaho,M12,2005,3.6,26702,708567,735269
Idaho,M11,2005,3.6,26220,708692,734912
Idaho,M10,2005,3.1,23186,714826,738012
Idaho,M09,2005,3.2,23562,711843,735405
Idaho,M08,2005,3.5,26060,713981,740041
Idaho,M07,2005,3.6,26801,718124,744925
Idaho,M06,2005,3.7,27587,713104,740691
Idaho,M05,2005,3.7,26662,702942,729604
Idaho,M04,2005,4.4,32064,692647,724711
Idaho,M03,2005,4.9,35669,686217,721886
Idaho,M02,2005,5.2,37674,681854,719528
Idaho,M01,2005,5.6,40362,674691,715053
Idaho,M12,2004,4.7,33673,679554,713227
Idaho,M11,2004,4.5,32189,678348,710537
Idaho,M10,2004,4.1,29264,681448,710712
Idaho,M09,2004,4.1,29066,676112,705178
Idaho,M08,2004,4.4,31439,678132,709571
Idaho,M07,2004,4.3,30814,682537,713351
Idaho,M06,2004,4.5,31921,678165,710086
Idaho,M05,2004,4.4,30501,668043,698544
Idaho,M04,2004,5.2,35930,657538,693468
Idaho,M03,2004,6.1,42141,651449,693590
Idaho,M02,2004,6.2,43165,647565,690730
Idaho,M01,2004,6.6,45349,642404,687753
Idaho,M12,2003,5.5,38165,651648,689813
Idaho,M11,2003,5.3,36465,652359,688824
Idaho,M10,2003,4.8,32860,657796,690656
Idaho,M09,2003,4.7,32153,654495,686648
Idaho,M08,2003,5.2,36035,656736,692771
Idaho,M07,2003,5.2,36504,662331,698835
Idaho,M06,2003,5.2,36702,662538,699240
Idaho,M05,2003,5.2,35984,653439,689423
Idaho,M04,2003,6.1,42007,645349,687356
Idaho,M03,2003,6.6,45261,642074,687335
Idaho,M02,2003,6.6,45297,639931,685228
Idaho,M01,2003,6.8,46608,637321,683929
Idaho,M12,2002,5.7,39164,645978,685142
Idaho,M11,2002,5.4,36944,647230,684174
Idaho,M10,2002,4.6,31567,655376,686943
Idaho,M09,2002,4.6,31346,652480,683826
Idaho,M08,2002,4.9,33814,654892,688706
Idaho,M07,2002,4.9,33884,660659,694543
Idaho,M06,2002,5.0,34830,658498,693328
Idaho,M05,2002,5.0,33826,649180,683006
Idaho,M04,2002,6.1,41387,639090,680477
Idaho,M03,2002,6.7,45688,634219,679907
Idaho,M02,2002,6.9,46514,632423,678937
Idaho,M01,2002,7.0,47541,628559,676100
Idaho,M12,2001,5.6,37926,641033,678959
Idaho,M11,2001,5.3,35837,643903,679740
Idaho,M10,2001,4.5,30859,652330,683189
Idaho,M09,2001,4.4,30263,651353,681616
Idaho,M08,2001,4.7,31976,653704,685680
Idaho,M07,2001,4.5,30728,658927,689655
Idaho,M06,2001,4.6,31651,655844,687495
Idaho,M05,2001,4.5,30455,646296,676751
Idaho,M04,2001,5.4,35992,635834,671826
Idaho,M03,2001,5.8,38738,631502,670240
Idaho,M02,2001,5.9,39056,626610,665666
Idaho,M01,2001,5.9,39136,622023,661159
Idaho,M12,2000,5.0,33028,630755,663783
Idaho,M11,2000,4.6,30761,631770,662531
Idaho,M10,2000,4.0,26450,637322,663772
Idaho,M09,2000,3.9,26103,635141,661244
Idaho,M08,2000,4.3,28320,637408,665728
Idaho,M07,2000,4.1,27457,641563,669020
Idaho,M06,2000,4.2,28145,640241,668386
Idaho,M05,2000,4.1,27017,631133,658150
Idaho,M04,2000,4.9,32049,622033,654082
Idaho,M03,2000,5.6,36190,615496,651686
Idaho,M02,2000,5.8,37563,613105,650668
Idaho,M01,2000,6.0,38676,610156,648832
North Dakota,M12,2016,3.1,12674,399792,412466
North Dakota,M11,2016,2.6,10765,402964,413729
North Dakota,M10,2016,2.2,9260,407995,417255
North Dakota,M09,2016,2.4,10058,407574,417632
North Dakota,M08,2016,2.9,12150,411853,424003
North Dakota,M07,2016,2.9,12420,412457,424877
North Dakota,M06,2016,3.5,14765,410421,425186
North Dakota,M05,2016,2.9,12292,404745,417037
North Dakota,M04,2016,3.4,14068,399168,413236
North Dakota,M03,2016,4.1,16909,394577,411486
North Dakota,M02,2016,4.0,16456,393235,409691
North Dakota,M01,2016,3.9,16099,392028,408127
North Dakota,M12,2015,3.0,12068,396301,408369
North Dakota,M11,2015,2.5,10166,399103,409269
North Dakota,M10,2015,2.0,8413,403977,412390
North Dakota,M09,2015,2.2,9130,403673,412803
North Dakota,M08,2015,2.6,10905,408510,419415
North Dakota,M07,2015,2.6,11032,410202,421234
North Dakota,M06,2015,3.1,13015,410091,423106
North Dakota,M05,2015,2.6,10665,405535,416200
North Dakota,M04,2015,2.8,11709,401292,413001
North Dakota,M03,2015,3.4,14120,398127,412247
North Dakota,M02,2015,3.4,13912,397727,411639
North Dakota,M01,2015,3.4,13793,397512,411305
North Dakota,M12,2014,2.6,10942,402208,413150
North Dakota,M11,2014,2.4,9782,405300,415082
North Dakota,M10,2014,2.0,8322,410129,418451
North Dakota,M09,2014,2.1,8870,409063,417933
North Dakota,M08,2014,2.5,10417,413526,423943
North Dakota,M07,2014,2.5,10470,414511,424981
North Dakota,M06,2014,2.9,12335,412839,425174
North Dakota,M05,2014,2.4,9784,406180,415964
North Dakota,M04,2014,2.8,11390,399810,411200
North Dakota,M03,2014,3.3,13669,394674,408343
North Dakota,M02,2014,3.4,13880,392289,406169
North Dakota,M01,2014,3.5,13961,389898,403859
North Dakota,M12,2013,2.8,11122,392775,403897
North Dakota,M11,2013,2.4,9783,395563,405346
North Dakota,M10,2013,2.0,8315,399558,407873
North Dakota,M09,2013,2.2,9054,399581,408635
North Dakota,M08,2013,2.6,10862,403695,414557
North Dakota,M07,2013,2.6,10931,404431,415362
North Dakota,M06,2013,3.1,12949,403510,416459
North Dakota,M05,2013,2.6,10658,397644,408302
North Dakota,M04,2013,3.2,12910,391389,404299
North Dakota,M03,2013,3.7,14828,387045,401873
North Dakota,M02,2013,3.7,14779,384916,399695
North Dakota,M01,2013,3.8,15303,382450,397753
North Dakota,M12,2012,3.1,12255,385193,397448
North Dakota,M11,2012,2.7,10923,386542,397465
North Dakota,M10,2012,2.4,9426,391375,400801
North Dakota,M09,2012,2.5,9919,390286,400205
North Dakota,M08,2012,2.8,11366,393959,405325
North Dakota,M07,2012,2.8,11565,394759,406324
North Dakota,M06,2012,3.3,13307,393353,406660
North Dakota,M05,2012,2.7,10719,387279,397998
North Dakota,M04,2012,3.1,12057,381715,393772
North Dakota,M03,2012,3.7,14665,376587,391252
North Dakota,M02,2012,3.8,14833,374496,389329
North Dakota,M01,2012,3.9,15276,372538,387814
North Dakota,M12,2011,3.3,12701,375134,387835
North Dakota,M11,2011,3.0,11562,376998,388560
North Dakota,M10,2011,2.7,10506,380878,391384
North Dakota,M09,2011,2.9,11166,380206,391372
North Dakota,M08,2011,3.4,13313,383568,396881
North Dakota,M07,2011,3.3,13124,383854,396978
North Dakota,M06,2011,3.8,14909,382030,396939
North Dakota,M05,2011,3.1,12157,376481,388638
North Dakota,M04,2011,3.6,13659,371036,384695
North Dakota,M03,2011,4.2,15942,366358,382300
North Dakota,M02,2011,4.3,16233,363829,380062
North Dakota,M01,2011,4.4,16503,361468,377971
North Dakota,M12,2010,3.7,13899,363715,377614
North Dakota,M11,2010,3.2,12192,365468,377660
North Dakota,M10,2010,2.8,10723,369587,380310
North Dakota,M09,2010,3.0,11314,368144,379458
North Dakota,M08,2010,3.5,13466,372575,386041
North Dakota,M07,2010,3.6,13806,373533,387339
North Dakota,M06,2010,4.1,15830,372242,388072
North Dakota,M05,2010,3.4,12846,367033,379879
North Dakota,M04,2010,3.8,14424,361471,375895
North Dakota,M03,2010,4.8,17760,354778,372538
North Dakota,M02,2010,4.8,17616,351587,369203
North Dakota,M01,2010,4.8,17586,348506,366092
North Dakota,M12,2009,4.1,15063,350200,365263
North Dakota,M11,2009,3.6,13065,351999,365064
North Dakota,M10,2009,3.2,11639,355772,367411
North Dakota,M09,2009,3.3,12178,355070,367248
North Dakota,M08,2009,3.8,14239,359616,373855
North Dakota,M07,2009,3.9,14496,361155,375651
North Dakota,M06,2009,4.5,16809,360582,377391
North Dakota,M05,2009,3.9,14398,355370,369768
North Dakota,M04,2009,4.4,16129,350275,366404
North Dakota,M03,2009,5.0,18096,347410,365506
North Dakota,M02,2009,5.1,18503,347371,365874
North Dakota,M01,2009,4.9,17901,346641,364542
North Dakota,M12,2008,3.5,12732,351501,364233
North Dakota,M11,2008,2.9,10771,355159,365930
North Dakota,M10,2008,2.5,9068,360836,369904
North Dakota,M09,2008,2.6,9610,361246,370856
North Dakota,M08,2008,3.0,11374,366928,378302
North Dakota,M07,2008,3.1,11790,369277,381067
North Dakota,M06,2008,3.4,13060,368466,381526
North Dakota,M05,2008,2.7,10008,363561,373569
North Dakota,M04,2008,3.1,11381,358497,369878
North Dakota,M03,2008,3.7,13418,354058,367476
North Dakota,M02,2008,3.7,13396,352133,365529
North Dakota,M01,2008,3.8,13698,350332,364030
North Dakota,M12,2007,3.2,11602,352384,363986
North Dakota,M11,2007,2.6,9606,354528,364134
North Dakota,M10,2007,2.3,8520,358549,367069
North Dakota,M09,2007,2.5,9159,357657,366816
North Dakota,M08,2007,2.8,10591,362197,372788
North Dakota,M07,2007,2.9,10897,364316,375213
North Dakota,M06,2007,3.4,12970,363686,376656
North Dakota,M05,2007,2.7,10127,358290,368417
North Dakota,M04,2007,3.3,12105,353048,365153
North Dakota,M03,2007,3.9,14016,349760,363776
North Dakota,M02,2007,3.9,14066,348269,362335
North Dakota,M01,2007,3.9,13962,346511,360473
North Dakota,M12,2006,3.1,11311,349367,360678
North Dakota,M11,2006,3.0,10990,350719,361709
North Dakota,M10,2006,2.5,8999,354686,363685
North Dakota,M09,2006,2.5,8924,353384,362308
North Dakota,M08,2006,2.9,10848,357330,368178
North Dakota,M07,2006,3.0,11251,357769,369020
North Dakota,M06,2006,3.5,13072,356872,369944
North Dakota,M05,2006,2.9,10330,351429,361759
North Dakota,M04,2006,3.3,11856,346100,357956
North Dakota,M03,2006,3.9,13889,342000,355889
North Dakota,M02,2006,4.0,14036,340098,354134
North Dakota,M01,2006,4.0,14155,338094,352249
North Dakota,M12,2005,3.3,11693,340923,352616
North Dakota,M11,2005,2.9,10206,343002,353208
North Dakota,M10,2005,2.6,9113,347592,356705
North Dakota,M09,2005,2.7,9670,346648,356318
North Dakota,M08,2005,3.1,11096,351212,362308
North Dakota,M07,2005,3.1,11438,351942,363380
North Dakota,M06,2005,3.8,13728,350391,364119
North Dakota,M05,2005,3.1,10987,345244,356231
North Dakota,M04,2005,3.5,12283,340432,352715
North Dakota,M03,2005,4.2,14626,336054,350680
North Dakota,M02,2005,4.2,14664,335030,349694
North Dakota,M01,2005,4.3,14940,333626,348566
North Dakota,M12,2004,3.6,12459,337271,349730
North Dakota,M11,2004,3.0,10386,339941,350327
North Dakota,M10,2004,2.6,9193,344867,354060
North Dakota,M09,2004,2.7,9630,343594,353224
North Dakota,M08,2004,3.1,11343,348756,360099
North Dakota,M07,2004,3.2,11415,350273,361688
North Dakota,M06,2004,3.7,13334,348339,361673
North Dakota,M05,2004,3.0,10442,342621,353063
North Dakota,M04,2004,3.4,11958,337325,349283
North Dakota,M03,2004,4.2,14700,332531,347231
North Dakota,M02,2004,4.3,14809,330734,345543
North Dakota,M01,2004,4.4,15081,328584,343665
North Dakota,M12,2003,3.5,12159,331524,343683
North Dakota,M11,2003,3.2,10932,333612,344544
North Dakota,M10,2003,2.7,9298,338252,347550
North Dakota,M09,2003,2.9,9912,336762,346674
North Dakota,M08,2003,3.4,12082,340738,352820
North Dakota,M07,2003,3.5,12169,340364,352533
North Dakota,M06,2003,4.0,14206,338780,352986
North Dakota,M05,2003,3.4,11579,332613,344192
North Dakota,M04,2003,4.0,13670,326914,340584
North Dakota,M03,2003,4.7,16005,322529,338534
North Dakota,M02,2003,4.7,15845,320927,336772
North Dakota,M01,2003,4.8,16029,319204,335233
North Dakota,M12,2002,3.8,12620,322739,335359
North Dakota,M11,2002,3.4,11561,325114,336675
North Dakota,M10,2002,2.9,9756,330534,340290
North Dakota,M09,2002,3.0,10120,330488,340608
North Dakota,M08,2002,3.4,11727,335352,347079
North Dakota,M07,2002,3.5,12176,336591,348767
North Dakota,M06,2002,4.1,14229,336208,350437
North Dakota,M05,2002,3.4,11628,330895,342523
North Dakota,M04,2002,4.0,13641,325697,339338
North Dakota,M03,2002,4.5,15212,321667,336879
North Dakota,M02,2002,4.4,14721,321204,335925
North Dakota,M01,2002,4.4,14699,318993,333692
North Dakota,M12,2001,3.4,11398,323098,334496
North Dakota,M11,2001,2.7,9094,326054,335148
North Dakota,M10,2001,2.2,7384,332098,339482
North Dakota,M09,2001,2.2,7326,332389,339715
North Dakota,M08,2001,2.6,9060,337469,346529
North Dakota,M07,2001,2.6,9202,340195,349397
North Dakota,M06,2001,3.2,11250,341301,352551
North Dakota,M05,2001,2.4,8368,336282,344650
North Dakota,M04,2001,3.1,10483,331675,342158
North Dakota,M03,2001,3.6,12099,328351,340450
North Dakota,M02,2001,3.6,12197,327274,339471
North Dakota,M01,2001,3.6,12094,325654,337748
North Dakota,M12,2000,2.9,9830,328919,338749
North Dakota,M11,2000,2.6,8678,330543,339221
North Dakota,M10,2000,2.0,6697,335718,342415
North Dakota,M09,2000,2.2,7391,334897,342288
North Dakota,M08,2000,2.8,9876,340525,350401
North Dakota,M07,2000,2.7,9462,341888,351350
North Dakota,M06,2000,3.3,11478,340247,351725
North Dakota,M05,2000,2.5,8638,334772,343410
North Dakota,M04,2000,3.1,10470,329678,340148
North Dakota,M03,2000,3.8,12988,325506,338494
North Dakota,M02,2000,3.8,12929,323896,336825
North Dakota,M01,2000,4.0,13490,322295,335785
Minnesota,M12,2016,4.1,121941,2872658,2994599
Minnesota,M11,2016,3.4,102107,2895799,2997906
Minnesota,M10,2016,3.4,103221,2900044,3003265
Minnesota,M09,2016,3.6,108951,2892541,3001492
Minnesota,M08,2016,3.8,113799,2902997,3016796
Minnesota,M07,2016,3.8,115174,2916987,3032161
Minnesota,M06,2016,4.0,119516,2901320,3020836
Minnesota,M05,2016,3.3,98186,2897167,2995353
Minnesota,M04,2016,3.7,111721,2879401,2991122
Minnesota,M03,2016,4.6,138515,2858882,2997397
Minnesota,M02,2016,4.5,135154,2851893,2987047
Minnesota,M01,2016,4.6,136200,2839403,2975603
Minnesota,M12,2015,3.7,110918,2863760,2974678
Minnesota,M11,2015,3.1,93440,2878869,2972309
Minnesota,M10,2015,3.1,90812,2885197,2976009
Minnesota,M09,2015,3.2,94583,2869731,2964314
Minnesota,M08,2015,3.3,99779,2884342,2984121
Minnesota,M07,2015,3.6,109704,2896571,3006275
Minnesota,M06,2015,3.8,114881,2887035,3001916
Minnesota,M05,2015,3.5,105859,2881587,2987446
Minnesota,M04,2015,3.6,108083,2858040,2966123
Minnesota,M03,2015,4.5,132346,2830748,2963094
Minnesota,M02,2015,4.5,132973,2823411,2956384
Minnesota,M01,2015,4.7,138013,2815714,2953727
Minnesota,M12,2014,3.8,111260,2843066,2954326
Minnesota,M11,2014,3.3,98902,2862325,2961227
Minnesota,M10,2014,3.1,92403,2868860,2961263
Minnesota,M09,2014,3.5,103462,2849804,2953266
Minnesota,M08,2014,3.8,111779,2858852,2970631
Minnesota,M07,2014,4.0,121181,2871361,2992542
Minnesota,M06,2014,4.2,125126,2857896,2983022
Minnesota,M05,2014,3.9,114081,2843416,2957497
Minnesota,M04,2014,4.3,127715,2820600,2948315
Minnesota,M03,2014,5.4,158252,2798938,2957190
Minnesota,M02,2014,5.4,159336,2791345,2950681
Minnesota,M01,2014,5.5,161146,2784875,2946021
Minnesota,M12,2013,4.5,132808,2812839,2945647
Minnesota,M11,2013,4.1,119609,2830891,2950500
Minnesota,M10,2013,4.1,121065,2831161,2952226
Minnesota,M09,2013,4.4,129223,2824686,2953909
Minnesota,M08,2013,4.6,137459,2828484,2965943
Minnesota,M07,2013,4.9,147537,2837163,2984700
Minnesota,M06,2013,5.1,153436,2826996,2980432
Minnesota,M05,2013,4.7,138281,2817923,2956204
Minnesota,M04,2013,5.1,150292,2793946,2944238
Minnesota,M03,2013,5.7,167973,2772425,2940398
Minnesota,M02,2013,5.9,173752,2767950,2941702
Minnesota,M01,2013,6.3,186715,2760588,2947303
Minnesota,M12,2012,5.3,155488,2789890,2945378
Minnesota,M11,2012,4.7,140062,2810976,2951038
Minnesota,M10,2012,4.9,144069,2817229,2961298
Minnesota,M09,2012,5.0,147817,2800446,2948263
Minnesota,M08,2012,5.5,162939,2798828,2961767
Minnesota,M07,2012,5.8,172165,2808439,2980604
Minnesota,M06,2012,5.8,171864,2795834,2967698
Minnesota,M05,2012,5.3,155240,2786208,2941448
Minnesota,M04,2012,5.4,159146,2766770,2925916
Minnesota,M03,2012,6.5,189604,2742182,2931786
Minnesota,M02,2012,6.6,192289,2732938,2925227
Minnesota,M01,2012,6.6,191898,2723946,2915844
Minnesota,M12,2011,5.7,166614,2766181,2932795
Minnesota,M11,2011,5.3,154749,2784023,2938772
Minnesota,M10,2011,5.4,159561,2788498,2948059
Minnesota,M09,2011,5.9,172657,2778078,2950735
Minnesota,M08,2011,6.2,184189,2781194,2965383
Minnesota,M07,2011,7.1,212461,2778197,2990658
Minnesota,M06,2011,6.8,200743,2769917,2970660
Minnesota,M05,2011,6.3,186718,2762788,2949506
Minnesota,M04,2011,6.6,194420,2741847,2936267
Minnesota,M03,2011,7.4,216669,2715033,2931702
Minnesota,M02,2011,7.5,218025,2703462,2921487
Minnesota,M01,2011,7.7,225374,2693944,2919318
Minnesota,M12,2010,7.0,204298,2722034,2926332
Minnesota,M11,2010,6.7,197739,2743013,2940752
Minnesota,M10,2010,6.6,193574,2749640,2943214
Minnesota,M09,2010,6.9,203430,2738052,2941482
Minnesota,M08,2010,7.1,211035,2748978,2960013
Minnesota,M07,2010,7.3,215627,2757338,2972965
Minnesota,M06,2010,7.3,215826,2741959,2957785
Minnesota,M05,2010,7.0,206306,2731981,2938287
Minnesota,M04,2010,7.5,218797,2715352,2934149
Minnesota,M03,2010,8.6,250510,2678868,2929378
Minnesota,M02,2010,8.4,245908,2666709,2912617
Minnesota,M01,2010,8.5,248166,2660407,2908573
Minnesota,M12,2009,7.5,218596,2693514,2912110
Minnesota,M11,2009,7.2,209607,2719313,2928920
Minnesota,M10,2009,7.1,209456,2722250,2931706
Minnesota,M09,2009,7.5,220789,2709521,2930310
Minnesota,M08,2009,7.7,227260,2731186,2958446
Minnesota,M07,2009,7.9,234863,2745605,2980468
Minnesota,M06,2009,8.2,244630,2731686,2976316
Minnesota,M05,2009,7.6,223803,2724287,2948090
Minnesota,M04,2009,7.8,229756,2712684,2942440
Minnesota,M03,2009,8.5,250738,2688497,2939235
Minnesota,M02,2009,8.3,242595,2689152,2931747
Minnesota,M01,2009,7.9,230511,2693419,2923930
Minnesota,M12,2008,6.6,192110,2740736,2932846
Minnesota,M11,2008,5.7,166249,2771613,2937862
Minnesota,M10,2008,5.2,152922,2785016,2937938
Minnesota,M09,2008,5.4,157716,2775826,2933542
Minnesota,M08,2008,5.4,158404,2791812,2950216
Minnesota,M07,2008,5.4,160192,2803784,2963976
Minnesota,M06,2008,5.4,157796,2789690,2947486
Minnesota,M05,2008,4.9,142033,2775934,2917967
Minnesota,M04,2008,5.0,144996,2761727,2906723
Minnesota,M03,2008,5.5,158646,2739199,2897845
Minnesota,M02,2008,5.3,154189,2731024,2885213
Minnesota,M01,2008,5.5,159701,2729744,2889445
Minnesota,M12,2007,4.8,138488,2764288,2902776
Minnesota,M11,2007,4.0,117642,2789384,2907026
Minnesota,M10,2007,4.0,117397,2791948,2909345
Minnesota,M09,2007,4.4,129433,2781982,2911415
Minnesota,M08,2007,4.3,124869,2795704,2920573
Minnesota,M07,2007,4.4,130089,2809946,2940035
Minnesota,M06,2007,4.6,134480,2795985,2930465
Minnesota,M05,2007,4.1,118504,2780566,2899070
Minnesota,M04,2007,4.6,134021,2762612,2896633
Minnesota,M03,2007,5.1,146650,2744396,2891046
Minnesota,M02,2007,5.1,146137,2735280,2881417
Minnesota,M01,2007,5.4,154518,2732358,2886876
Minnesota,M12,2006,4.2,121680,2769498,2891178
Minnesota,M11,2006,3.7,108382,2787911,2896293
Minnesota,M10,2006,3.4,99340,2793579,2892919
Minnesota,M09,2006,3.7,107709,2779794,2887503
Minnesota,M08,2006,3.5,102772,2796249,2899021
Minnesota,M07,2006,3.7,108490,2805453,2913943
Minnesota,M06,2006,3.8,110230,2793229,2903459
Minnesota,M05,2006,3.3,95752,2776161,2871913
Minnesota,M04,2006,4.0,113863,2759841,2873704
Minnesota,M03,2006,4.7,135929,2741184,2877113
Minnesota,M02,2006,4.9,141689,2732216,2873905
Minnesota,M01,2006,5.0,142762,2730262,2873024
Minnesota,M12,2005,4.0,114975,2764735,2879710
Minnesota,M11,2005,3.7,106564,2784660,2891224
Minnesota,M10,2005,3.4,97670,2794018,2891688
Minnesota,M09,2005,3.7,107746,2778931,2886677
Minnesota,M08,2005,3.4,98758,2794816,2893574
Minnesota,M07,2005,3.6,105050,2800662,2905712
Minnesota,M06,2005,4.0,116368,2782265,2898633
Minnesota,M05,2005,3.7,106870,2771061,2877931
Minnesota,M04,2005,4.2,120241,2751546,2871787
Minnesota,M03,2005,5.0,142521,2718091,2860612
Minnesota,M02,2005,5.0,142255,2707734,2849989
Minnesota,M01,2005,5.1,145302,2704272,2849574
Minnesota,M12,2004,4.2,120985,2746650,2867635
Minnesota,M11,2004,3.9,111833,2768020,2879853
Minnesota,M10,2004,3.9,111155,2774226,2885381
Minnesota,M09,2004,4.3,124189,2758172,2882361
Minnesota,M08,2004,4.4,128015,2772929,2900944
Minnesota,M07,2004,4.6,133889,2781377,2915266
Minnesota,M06,2004,4.9,142904,2765249,2908153
Minnesota,M05,2004,4.3,122528,2752643,2875171
Minnesota,M04,2004,4.6,133173,2736524,2869697
Minnesota,M03,2004,5.7,164832,2704374,2869206
Minnesota,M02,2004,5.5,156169,2696743,2852912
Minnesota,M01,2004,5.9,168084,2690467,2858551
Minnesota,M12,2003,4.8,136141,2726595,2862736
Minnesota,M11,2003,4.5,129163,2747950,2877113
Minnesota,M10,2003,4.4,125373,2755752,2881125
Minnesota,M09,2003,4.7,136756,2743717,2880473
Minnesota,M08,2003,4.6,133782,2760156,2893938
Minnesota,M07,2003,4.9,143065,2766582,2909647
Minnesota,M06,2003,5.2,151787,2754823,2906610
Minnesota,M05,2003,4.4,127356,2742606,2869962
Minnesota,M04,2003,4.9,140860,2727058,2867918
Minnesota,M03,2003,5.4,153142,2702315,2855457
Minnesota,M02,2003,5.2,149259,2694945,2844204
Minnesota,M01,2003,5.5,157831,2688948,2846779
Minnesota,M12,2002,4.3,121865,2724681,2846546
Minnesota,M11,2002,3.9,112775,2746614,2859389
Minnesota,M10,2002,3.6,103979,2757379,2861358
Minnesota,M09,2002,4.0,114298,2747553,2861851
Minnesota,M08,2002,4.0,116208,2758465,2874673
Minnesota,M07,2002,4.4,126510,2766024,2892534
Minnesota,M06,2002,4.7,134596,2749637,2884233
Minnesota,M05,2002,4.1,115511,2735782,2851293
Minnesota,M04,2002,4.9,139902,2716845,2856747
Minnesota,M03,2002,5.4,154484,2696507,2850991
Minnesota,M02,2002,5.3,149208,2691429,2840637
Minnesota,M01,2002,5.4,152924,2682044,2834968
Minnesota,M12,2001,4.3,121022,2723043,2844065
Minnesota,M11,2001,3.8,109344,2745303,2854647
Minnesota,M10,2001,3.4,97282,2756330,2853612
Minnesota,M09,2001,3.5,98938,2744986,2843924
Minnesota,M08,2001,3.5,100492,2755618,2856110
Minnesota,M07,2001,3.5,101579,2771577,2873156
Minnesota,M06,2001,3.8,109713,2757672,2867385
Minnesota,M05,2001,3.2,90230,2746494,2836724
Minnesota,M04,2001,3.8,108075,2731056,2839131
Minnesota,M03,2001,4.3,120898,2715862,2836760
Minnesota,M02,2001,4.0,113052,2707080,2820132
Minnesota,M01,2001,4.1,116273,2700510,2816783
Minnesota,M12,2000,3.1,88496,2735833,2824329
Minnesota,M11,2000,3.0,85736,2749750,2835486
Minnesota,M10,2000,2.7,77844,2754030,2831874
Minnesota,M09,2000,3.0,85999,2739806,2825805
Minnesota,M08,2000,2.9,83178,2752213,2835391
Minnesota,M07,2000,2.9,82561,2757526,2840087
Minnesota,M06,2000,3.1,86910,2744710,2831620
Minnesota,M05,2000,2.8,78159,2726224,2804383
Minnesota,M04,2000,2.9,82034,2711951,2793985
Minnesota,M03,2000,3.8,105252,2684558,2789810
Minnesota,M02,2000,3.7,101454,2671851,2773305
Minnesota,M01,2000,3.9,108326,2660963,2769289
New Hampshire,M12,2016,2.5,18907,728556,747463
New Hampshire,M11,2016,2.6,19573,729720,749293
New Hampshire,M10,2016,2.5,18430,729792,748222
New Hampshire,M09,2016,2.6,19415,727548,746963
New Hampshire,M08,2016,2.8,20933,737236,758169
New Hampshire,M07,2016,2.8,21521,740418,761939
New Hampshire,M06,2016,2.9,21559,733329,754888
New Hampshire,M05,2016,2.7,20206,722805,743011
New Hampshire,M04,2016,2.8,20652,720696,741348
New Hampshire,M03,2016,3.2,23501,721319,744820
New Hampshire,M02,2016,3.3,24367,719307,743674
New Hampshire,M01,2016,3.3,24654,718318,742972
New Hampshire,M12,2015,2.7,20176,720757,740933
New Hampshire,M11,2015,2.9,21576,720796,742372
New Hampshire,M10,2015,2.8,20700,719757,740457
New Hampshire,M09,2015,2.9,21697,716875,738572
New Hampshire,M08,2015,3.1,23312,727916,751228
New Hampshire,M07,2015,3.3,24633,731455,756088
New Hampshire,M06,2015,3.4,25227,725279,750506
New Hampshire,M05,2015,3.3,24388,714622,739010
New Hampshire,M04,2015,3.5,25644,709773,735417
New Hampshire,M03,2015,4.0,29830,710874,740704
New Hampshire,M02,2015,4.3,31427,706927,738354
New Hampshire,M01,2015,4.3,32147,707676,739823
New Hampshire,M12,2014,3.7,27290,710985,738275
New Hampshire,M11,2014,3.8,28139,710898,739037
New Hampshire,M10,2014,3.6,26823,711241,738064
New Hampshire,M09,2014,3.8,28179,708735,736914
New Hampshire,M08,2014,4.1,30641,715931,746572
New Hampshire,M07,2014,4.1,31245,722916,754161
New Hampshire,M06,2014,4.2,31578,717094,748672
New Hampshire,M05,2014,4.2,30867,705135,736002
New Hampshire,M04,2014,4.4,32475,702729,735204
New Hampshire,M03,2014,4.9,36547,703674,740221
New Hampshire,M02,2014,5.1,37887,701422,739309
New Hampshire,M01,2014,5.2,38348,701137,739485
New Hampshire,M12,2013,4.6,33615,705101,738716
New Hampshire,M11,2013,4.7,34928,705360,740288
New Hampshire,M10,2013,4.6,33866,704535,738401
New Hampshire,M09,2013,4.7,34803,702470,737273
New Hampshire,M08,2013,4.8,36003,714351,750354
New Hampshire,M07,2013,4.9,36956,716776,753732
New Hampshire,M06,2013,5.0,37138,711608,748746
New Hampshire,M05,2013,4.9,36112,701933,738045
New Hampshire,M04,2013,5.1,37879,697735,735614
New Hampshire,M03,2013,5.7,42418,698718,741136
New Hampshire,M02,2013,5.9,43942,696697,740639
New Hampshire,M01,2013,6.1,44936,696436,741372
New Hampshire,M12,2012,5.3,39476,700092,739568
New Hampshire,M11,2012,5.3,39438,701323,740761
New Hampshire,M10,2012,5.2,38406,701728,740134
New Hampshire,M09,2012,5.3,38849,700683,739532
New Hampshire,M08,2012,5.4,40754,710464,751218
New Hampshire,M07,2012,5.5,41357,713641,754998
New Hampshire,M06,2012,5.5,40942,707637,748579
New Hampshire,M05,2012,5.3,38992,696096,735088
New Hampshire,M04,2012,5.3,38936,693350,732286
New Hampshire,M03,2012,5.8,42840,695135,737975
New Hampshire,M02,2012,6.1,44557,691523,736080
New Hampshire,M01,2012,6.0,44160,692782,736942
New Hampshire,M12,2011,5.2,38089,697021,735110
New Hampshire,M11,2011,5.2,38440,697397,735837
New Hampshire,M10,2011,5.1,37294,697006,734300
New Hampshire,M09,2011,5.2,38151,695308,733459
New Hampshire,M08,2011,5.4,39997,704706,744703
New Hampshire,M07,2011,5.3,39971,708381,748352
New Hampshire,M06,2011,5.4,39707,702371,742078
New Hampshire,M05,2011,5.1,37647,693466,731113
New Hampshire,M04,2011,5.2,38276,691601,729877
New Hampshire,M03,2011,5.7,41929,692522,734451
New Hampshire,M02,2011,5.9,43537,689227,732764
New Hampshire,M01,2011,6.0,44198,689382,733580
New Hampshire,M12,2010,5.3,38643,694325,732968
New Hampshire,M11,2010,5.3,39207,694787,733994
New Hampshire,M10,2010,5.2,37832,695879,733711
New Hampshire,M09,2010,5.3,39163,693846,733009
New Hampshire,M08,2010,5.5,41345,704785,746130
New Hampshire,M07,2010,5.6,41936,708483,750419
New Hampshire,M06,2010,5.7,42241,702755,744996
New Hampshire,M05,2010,5.6,41400,693764,735164
New Hampshire,M04,2010,5.9,43641,689875,733516
New Hampshire,M03,2010,6.7,49474,690054,739528
New Hampshire,M02,2010,6.9,51207,686230,737437
New Hampshire,M01,2010,7.0,51380,686834,738214
New Hampshire,M12,2009,6.0,44534,692658,737192
New Hampshire,M11,2009,6.0,44386,694146,738532
New Hampshire,M10,2009,5.8,43027,695162,738189
New Hampshire,M09,2009,6.1,45099,693382,738481
New Hampshire,M08,2009,6.2,46720,704453,751173
New Hampshire,M07,2009,6.3,47709,708194,755903
New Hampshire,M06,2009,6.5,49123,704253,753376
New Hampshire,M05,2009,6.4,47719,696049,743768
New Hampshire,M04,2009,6.5,48059,693190,741249
New Hampshire,M03,2009,6.7,49958,695532,745490
New Hampshire,M02,2009,6.3,47177,695942,743119
New Hampshire,M01,2009,5.9,43588,700659,744247
New Hampshire,M12,2008,4.5,33239,707234,740473
New Hampshire,M11,2008,4.0,29798,711084,740882
New Hampshire,M10,2008,3.5,26154,713847,740001
New Hampshire,M09,2008,3.6,26468,712896,739364
New Hampshire,M08,2008,3.7,27821,725716,753537
New Hampshire,M07,2008,3.6,27263,729305,756568
New Hampshire,M06,2008,3.6,27346,722354,749700
New Hampshire,M05,2008,3.5,26048,712154,738202
New Hampshire,M04,2008,3.7,27453,708663,736116
New Hampshire,M03,2008,4.2,30905,709570,740475
New Hampshire,M02,2008,4.2,31342,706967,738309
New Hampshire,M01,2008,4.1,30281,709455,739736
New Hampshire,M12,2007,3.2,23553,712956,736509
New Hampshire,M11,2007,3.2,23271,713476,736747
New Hampshire,M10,2007,3.0,21825,712762,734587
New Hampshire,M09,2007,3.1,22983,711369,734352
New Hampshire,M08,2007,3.3,24519,723032,747551
New Hampshire,M07,2007,3.3,25200,727089,752289
New Hampshire,M06,2007,3.5,25968,720086,746054
New Hampshire,M05,2007,3.4,24970,708505,733475
New Hampshire,M04,2007,3.7,26781,703562,730343
New Hampshire,M03,2007,4.1,30111,705736,735847
New Hampshire,M02,2007,4.3,31221,702434,733655
New Hampshire,M01,2007,4.2,30801,703093,733894
New Hampshire,M12,2006,3.4,24761,708649,733410
New Hampshire,M11,2006,3.4,24783,708312,733095
New Hampshire,M10,2006,3.1,22773,709011,731784
New Hampshire,M09,2006,3.2,23587,706971,730558
New Hampshire,M08,2006,3.3,24776,717554,742330
New Hampshire,M07,2006,3.3,25000,721389,746389
New Hampshire,M06,2006,3.4,24991,714307,739298
New Hampshire,M05,2006,3.2,23220,703089,726309
New Hampshire,M04,2006,3.3,23653,700727,724380
New Hampshire,M03,2006,3.7,27016,699759,726775
New Hampshire,M02,2006,3.9,28203,695521,723724
New Hampshire,M01,2006,3.9,28163,696032,724195
New Hampshire,M12,2005,3.2,22989,702830,725819
New Hampshire,M11,2005,3.3,23985,702836,726821
New Hampshire,M10,2005,3.2,23028,702724,725752
New Hampshire,M09,2005,3.3,24309,701410,725719
New Hampshire,M08,2005,3.4,25365,711367,736732
New Hampshire,M07,2005,3.4,25462,714878,740340
New Hampshire,M06,2005,3.6,26040,706722,732762
New Hampshire,M05,2005,3.4,24395,696690,721085
New Hampshire,M04,2005,3.5,25197,692682,717879
New Hampshire,M03,2005,4.1,29198,690731,719929
New Hampshire,M02,2005,4.2,30217,687706,717923
New Hampshire,M01,2005,4.1,29686,689732,719418
New Hampshire,M12,2004,3.3,23983,692842,716825
New Hampshire,M11,2004,3.4,24098,693522,717620
New Hampshire,M10,2004,3.2,22805,693961,716766
New Hampshire,M09,2004,3.3,23870,690972,714842
New Hampshire,M08,2004,3.5,25758,701663,727421
New Hampshire,M07,2004,3.6,26202,704589,730791
New Hampshire,M06,2004,3.7,26997,696102,723099
New Hampshire,M05,2004,3.6,25666,685491,711157
New Hampshire,M04,2004,3.8,26864,680686,707550
New Hampshire,M03,2004,4.4,31511,680174,711685
New Hampshire,M02,2004,4.7,33047,674818,707865
New Hampshire,M01,2004,4.7,33631,674983,708614
New Hampshire,M12,2003,3.9,27267,680466,707733
New Hampshire,M11,2003,4.0,28532,681390,709922
New Hampshire,M10,2003,3.9,27386,681096,708482
New Hampshire,M09,2003,4.1,28933,677569,706502
New Hampshire,M08,2003,4.2,30534,689840,720374
New Hampshire,M07,2003,4.3,30866,691589,722455
New Hampshire,M06,2003,4.3,30876,683636,714512
New Hampshire,M05,2003,4.1,28925,671967,700892
New Hampshire,M04,2003,4.3,30327,667533,697860
New Hampshire,M03,2003,4.8,33743,668121,701864
New Hampshire,M02,2003,4.8,33705,664842,698547
New Hampshire,M01,2003,5.0,34836,666316,701152
New Hampshire,M12,2002,4.2,29681,671559,701240
New Hampshire,M11,2002,4.4,30651,671800,702451
New Hampshire,M10,2002,4.2,29619,672400,702019
New Hampshire,M09,2002,4.3,30313,671178,701491
New Hampshire,M08,2002,4.4,31636,681728,713364
New Hampshire,M07,2002,4.3,30996,684865,715861
New Hampshire,M06,2002,4.5,31798,677322,709120
New Hampshire,M05,2002,4.3,29647,667209,696856
New Hampshire,M04,2002,4.4,30500,663611,694111
New Hampshire,M03,2002,4.8,33765,664694,698459
New Hampshire,M02,2002,4.9,34380,661519,695899
New Hampshire,M01,2002,4.9,33811,662673,696484
New Hampshire,M12,2001,3.9,27201,668287,695488
New Hampshire,M11,2001,3.9,27090,669342,696432
New Hampshire,M10,2001,3.6,25054,670565,695619
New Hampshire,M09,2001,3.7,25761,669490,695251
New Hampshire,M08,2001,3.7,25936,681309,707245
New Hampshire,M07,2001,3.5,24699,686059,710758
New Hampshire,M06,2001,3.3,23249,682251,705500
New Hampshire,M05,2001,2.9,20439,673377,693816
New Hampshire,M04,2001,3.0,20627,669931,690558
New Hampshire,M03,2001,3.3,22884,672491,695375
New Hampshire,M02,2001,3.3,22563,670470,693033
New Hampshire,M01,2001,3.2,22285,671762,694047
New Hampshire,M12,2000,2.4,16594,674449,691043
New Hampshire,M11,2000,2.4,16711,673844,690555
New Hampshire,M10,2000,2.3,15746,672248,687994
New Hampshire,M09,2000,2.4,16662,669552,686214
New Hampshire,M08,2000,2.6,18299,679508,697807
New Hampshire,M07,2000,2.6,18489,683694,702183
New Hampshire,M06,2000,2.7,18614,677308,695922
New Hampshire,M05,2000,2.5,17187,666099,683286
New Hampshire,M04,2000,2.6,17451,662417,679868
New Hampshire,M03,2000,3.0,20576,661607,682183
New Hampshire,M02,2000,3.2,21530,657285,678815
New Hampshire,M01,2000,3.2,21590,657441,679031
Alabama,M12,2016,5.9,129295,2050965,2180260
Alabama,M11,2016,5.7,123834,2060807,2184641
Alabama,M10,2016,6.2,136336,2057151,2193487
Alabama,M09,2016,6.2,134032,2042696,2176728
Alabama,M08,2016,6.2,134754,2033706,2168460
Alabama,M07,2016,6.1,132734,2040731,2173465
Alabama,M06,2016,6.3,137606,2040095,2177701
Alabama,M05,2016,5.4,116430,2042665,2159095
Alabama,M04,2016,5.3,113556,2040921,2154477
Alabama,M03,2016,6.0,129417,2031490,2160907
Alabama,M02,2016,6.3,135407,2017039,2152446
Alabama,M01,2016,6.3,134592,2007036,2141628
Alabama,M12,2015,5.9,127389,2030765,2158154
Alabama,M11,2015,5.7,122954,2035229,2158183
Alabama,M10,2015,5.9,126424,2032455,2158879
Alabama,M09,2015,5.9,127053,2017049,2144102
Alabama,M08,2015,6.5,139692,2015129,2154821
Alabama,M07,2015,6.6,143867,2022263,2166130
Alabama,M06,2015,6.7,145355,2024858,2170213
Alabama,M05,2015,6.1,132798,2029625,2162423
Alabama,M04,2015,5.5,118352,2025920,2144272
Alabama,M03,2015,5.9,126437,2013339,2139776
Alabama,M02,2015,6.2,133208,2003076,2136284
Alabama,M01,2015,6.4,135842,1998388,2134230
Alabama,M12,2014,5.7,121281,2023427,2144708
Alabama,M11,2014,5.8,124177,2033698,2157875
Alabama,M10,2014,6.0,130881,2035345,2166226
Alabama,M09,2014,6.3,134825,2016427,2151252
Alabama,M08,2014,7.1,153829,2007247,2161076
Alabama,M07,2014,7.5,163944,2015540,2179484
Alabama,M06,2014,7.4,161135,2019899,2181034
Alabama,M05,2014,6.6,143479,2020576,2164055
Alabama,M04,2014,6.2,134424,2019222,2153646
Alabama,M03,2014,7.5,162263,2010106,2172369
Alabama,M02,2014,7.9,170822,1994282,2165104
Alabama,M01,2014,7.5,162341,1989459,2151800
Alabama,M12,2013,6.7,143618,2013519,2157137
Alabama,M11,2013,6.7,144052,2020314,2164366
Alabama,M10,2013,7.0,152300,2012001,2164301
Alabama,M09,2013,7.2,156462,2011570,2168032
Alabama,M08,2013,7.5,162808,2004395,2167203
Alabama,M07,2013,7.6,165324,2014910,2180234
Alabama,M06,2013,7.7,168532,2019545,2188077
Alabama,M05,2013,6.7,146488,2025092,2171580
Alabama,M04,2013,6.3,136117,2022879,2158996
Alabama,M03,2013,7.1,154578,2009749,2164327
Alabama,M02,2013,8.0,173129,1997474,2170603
Alabama,M01,2013,8.2,177887,1988180,2166067
Alabama,M12,2012,7.2,156518,2016210,2172728
Alabama,M11,2012,6.9,149468,2023318,2172786
Alabama,M10,2012,7.5,165164,2025114,2190278
Alabama,M09,2012,7.6,165201,2007311,2172512
Alabama,M08,2012,8.5,185611,1991683,2177294
Alabama,M07,2012,9.0,197589,1998352,2195941
Alabama,M06,2012,9.0,197672,2005817,2203489
Alabama,M05,2012,7.8,170124,2008447,2178571
Alabama,M04,2012,7.2,156241,2007592,2163833
Alabama,M03,2012,7.9,172432,1999157,2171589
Alabama,M02,2012,8.4,182555,1982828,2165383
Alabama,M01,2012,8.3,177986,1973652,2151638
Alabama,M12,2011,7.9,172004,2004151,2176155
Alabama,M11,2011,8.0,175369,2008604,2183973
Alabama,M10,2011,8.9,194917,2005689,2200606
Alabama,M09,2011,9.5,208118,1993496,2201614
Alabama,M08,2011,10.0,219374,1983353,2202727
Alabama,M07,2011,10.4,229090,1984262,2213352
Alabama,M06,2011,10.6,235178,1986735,2221913
Alabama,M05,2011,9.6,211820,1994098,2205918
Alabama,M04,2011,9.4,207316,1996846,2204162
Alabama,M03,2011,9.9,218776,1987874,2206650
Alabama,M02,2011,10.5,232117,1972720,2204837
Alabama,M01,2011,11.0,243001,1967127,2210128
Alabama,M12,2010,9.8,217272,1996538,2213810
Alabama,M11,2010,10.0,222536,2001481,2224017
Alabama,M10,2010,9.9,219224,2001483,2220707
Alabama,M09,2010,9.8,216750,1990219,2206969
Alabama,M08,2010,10.1,224435,1988261,2212696
Alabama,M07,2010,10.2,225826,1990949,2216775
Alabama,M06,2010,10.5,234972,1994590,2229562
Alabama,M05,2010,9.9,219339,1994090,2213429
Alabama,M04,2010,10.4,229680,1976552,2206232
Alabama,M03,2010,11.5,245567,1892006,2137573
Alabama,M02,2010,12.1,258825,1876758,2135583
Alabama,M01,2010,12.3,263375,1871780,2135155
Alabama,M12,2009,11.4,242992,1894973,2137965
Alabama,M11,2009,11.1,238550,1910326,2148876
Alabama,M10,2009,11.7,252694,1906032,2158726
Alabama,M09,2009,11.5,246302,1900104,2146406
Alabama,M08,2009,11.9,257266,1909325,2166591
Alabama,M07,2009,11.8,256024,1922689,2178713
Alabama,M06,2009,11.9,260376,1929460,2189836
Alabama,M05,2009,10.6,228776,1936027,2164803
Alabama,M04,2009,9.9,214271,1947745,2162016
Alabama,M03,2009,10.4,225045,1941378,2166423
Alabama,M02,2009,10.5,227822,1943707,2171529
Alabama,M01,2009,9.7,208908,1955196,2164104
Alabama,M12,2008,7.6,164258,2008873,2173131
Alabama,M11,2008,6.7,145764,2030180,2175944
Alabama,M10,2008,6.3,137392,2047657,2185049
Alabama,M09,2008,5.9,127509,2042444,2169953
Alabama,M08,2008,6.2,135258,2045512,2180770
Alabama,M07,2008,6.0,132091,2060216,2192307
Alabama,M06,2008,5.9,128630,2066629,2195259
Alabama,M05,2008,4.9,106293,2068192,2174485
Alabama,M04,2008,4.0,86201,2076473,2162674
Alabama,M03,2008,4.7,101104,2069395,2170499
Alabama,M02,2008,4.9,106990,2060564,2167554
Alabama,M01,2008,4.8,104650,2065583,2170233
Alabama,M12,2007,4.3,93382,2096601,2189983
Alabama,M11,2007,3.9,85214,2107374,2192588
Alabama,M10,2007,3.8,82043,2099135,2181178
Alabama,M09,2007,4.0,87960,2086890,2174850
Alabama,M08,2007,4.3,92639,2078047,2170686
Alabama,M07,2007,4.4,94996,2087356,2182352
Alabama,M06,2007,4.2,92790,2091928,2184718
Alabama,M05,2007,3.3,72062,2086563,2158625
Alabama,M04,2007,3.3,70124,2086715,2156839
Alabama,M03,2007,3.8,81789,2094367,2176156
Alabama,M02,2007,4.2,91769,2078300,2170069
Alabama,M01,2007,4.3,93046,2076252,2169298
Alabama,M12,2006,3.7,82045,2107748,2189793
Alabama,M11,2006,3.7,80347,2105333,2185680
Alabama,M10,2006,3.6,79073,2103518,2182591
Alabama,M09,2006,3.9,84484,2081849,2166333
Alabama,M08,2006,4.4,96477,2079513,2175990
Alabama,M07,2006,4.6,101217,2080469,2181686
Alabama,M06,2006,4.6,99321,2083142,2182463
Alabama,M05,2006,3.6,77036,2075463,2152499
Alabama,M04,2006,3.5,76310,2074172,2150482
Alabama,M03,2006,3.9,84273,2068993,2153266
Alabama,M02,2006,4.5,96643,2053723,2150366
Alabama,M01,2006,4.4,93680,2048878,2142558
Alabama,M12,2005,3.9,83794,2079724,2163518
Alabama,M11,2005,4.0,86786,2078869,2165655
Alabama,M10,2005,4.2,91482,2078674,2170156
Alabama,M09,2005,4.3,91681,2057174,2148855
Alabama,M08,2005,4.5,97303,2053608,2150911
Alabama,M07,2005,4.7,100411,2052713,2153124
Alabama,M06,2005,5.0,107168,2048730,2155898
Alabama,M05,2005,4.0,85864,2048188,2134052
Alabama,M04,2005,3.9,83119,2045070,2128189
Alabama,M03,2005,4.6,97042,2028597,2125639
Alabama,M02,2005,5.4,115837,2014928,2130765
Alabama,M01,2005,5.4,114319,2011219,2125538
Alabama,M12,2004,4.9,105756,2041339,2147095
Alabama,M11,2004,5.2,111612,2043152,2154764
Alabama,M10,2004,5.5,119278,2035705,2154983
Alabama,M09,2004,5.6,119043,2015103,2134146
Alabama,M08,2004,5.9,126954,2015320,2142274
Alabama,M07,2004,6.0,128010,2019963,2147973
Alabama,M06,2004,6.1,131745,2013057,2144802
Alabama,M05,2004,5.4,114147,2009573,2123720
Alabama,M04,2004,5.2,111309,2009556,2120865
Alabama,M03,2004,5.9,126006,1999936,2125942
Alabama,M02,2004,6.1,130294,1990082,2120376
Alabama,M01,2004,6.4,134673,1985886,2120559
Alabama,M12,2003,5.7,121278,2012259,2133537
Alabama,M11,2003,6.1,131465,2014530,2145995
Alabama,M10,2003,6.1,130045,2009302,2139347
Alabama,M09,2003,6.0,126119,1988078,2114197
Alabama,M08,2003,6.4,135588,1983830,2119418
Alabama,M07,2003,6.3,134250,1985497,2119747
Alabama,M06,2003,6.9,146681,1989638,2136319
Alabama,M05,2003,5.6,117632,1989984,2107616
Alabama,M04,2003,5.3,112249,1995330,2107579
Alabama,M03,2003,5.6,117382,1989754,2107136
Alabama,M02,2003,6.0,127265,1980206,2107471
Alabama,M01,2003,6.2,129966,1974374,2104340
Alabama,M12,2002,5.7,121340,2001747,2123087
Alabama,M11,2002,5.8,122932,2003102,2126034
Alabama,M10,2002,5.6,118872,2006102,2124974
Alabama,M09,2002,5.7,121056,1990444,2111500
Alabama,M08,2002,6.2,129877,1977913,2107790
Alabama,M07,2002,6.2,130722,1976105,2106827
Alabama,M06,2002,6.3,132757,1975805,2108562
Alabama,M05,2002,5.2,109369,1978799,2088168
Alabama,M04,2002,5.3,110349,1977674,2088023
Alabama,M03,2002,6.0,125906,1974955,2100861
Alabama,M02,2002,6.3,132979,1966562,2099541
Alabama,M01,2002,6.5,134750,1953814,2088564
Alabama,M12,2001,5.8,124127,1998822,2122949
Alabama,M11,2001,5.8,124089,2001919,2126008
Alabama,M10,2001,5.6,118727,2006251,2124978
Alabama,M09,2001,5.3,110866,1998202,2109068
Alabama,M08,2001,5.6,118389,1990457,2108846
Alabama,M07,2001,5.1,107206,2005872,2113078
Alabama,M06,2001,5.2,110859,2008400,2119259
Alabama,M05,2001,4.0,84256,2013679,2097935
Alabama,M04,2001,4.2,88272,2018617,2106889
Alabama,M03,2001,4.7,99910,2021612,2121522
Alabama,M02,2001,5.0,105469,2009904,2115373
Alabama,M01,2001,5.2,110035,2008876,2118911
Alabama,M12,2000,4.2,90116,2045059,2135175
Alabama,M11,2000,4.4,94639,2043608,2138247
Alabama,M10,2000,4.5,96899,2042462,2139361
Alabama,M09,2000,4.5,95292,2028106,2123398
Alabama,M08,2000,5.0,106446,2025248,2131694
Alabama,M07,2000,4.9,103561,2029362,2132923
Alabama,M06,2000,4.9,104604,2040185,2144789
Alabama,M05,2000,4.1,86308,2037787,2124095
Alabama,M04,2000,3.8,80215,2045171,2125386
Alabama,M03,2000,4.5,95449,2038654,2134103
Alabama,M02,2000,5.1,109464,2027226,2136690
Alabama,M01,2000,5.1,108551,2024262,2132813
Kansas,M12,2016,3.8,56522,1418293,1474815
Kansas,M11,2016,3.8,56378,1426249,1482627
Kansas,M10,2016,4.0,59924,1424048,1483972
Kansas,M09,2016,4.1,60371,1417821,1478192
Kansas,M08,2016,4.6,67296,1410390,1477686
Kansas,M07,2016,4.8,72640,1430231,1502871
Kansas,M06,2016,4.5,68046,1430285,1498331
Kansas,M05,2016,3.9,57046,1418190,1475236
Kansas,M04,2016,3.8,56154,1423658,1479812
Kansas,M03,2016,4.2,62200,1422773,1484973
Kansas,M02,2016,4.2,62245,1423950,1486195
Kansas,M01,2016,4.3,63725,1419572,1483297
Kansas,M12,2015,3.6,53343,1432895,1486238
Kansas,M11,2015,3.6,53044,1439168,1492212
Kansas,M10,2015,3.7,54931,1435579,1490510
Kansas,M09,2015,3.7,54540,1426672,1481212
Kansas,M08,2015,4.2,62721,1420686,1483407
Kansas,M07,2015,4.7,70658,1436555,1507213
Kansas,M06,2015,4.6,68578,1435730,1504308
Kansas,M05,2015,4.3,63923,1420131,1484054
Kansas,M04,2015,4.2,62270,1422009,1484279
Kansas,M03,2015,4.5,66358,1418276,1484634
Kansas,M02,2015,4.6,67769,1418778,1486547
Kansas,M01,2015,4.8,70678,1414683,1485361
Kansas,M12,2014,3.8,57074,1429676,1486750
Kansas,M11,2014,3.9,58007,1437033,1495040
Kansas,M10,2014,4.0,59135,1435080,1494215
Kansas,M09,2014,4.2,61835,1425459,1487294
Kansas,M08,2014,4.7,69285,1418756,1488041
Kansas,M07,2014,5.1,77547,1438499,1516046
Kansas,M06,2014,4.9,73397,1439428,1512825
Kansas,M05,2014,4.5,67700,1423471,1491171
Kansas,M04,2014,4.2,62899,1425243,1488142
Kansas,M03,2014,4.9,73359,1419602,1492961
Kansas,M02,2014,5.1,76720,1414183,1490903
Kansas,M01,2014,5.2,76545,1407897,1484442
Kansas,M12,2013,4.4,65193,1418691,1483884
Kansas,M11,2013,4.5,67007,1422657,1489664
Kansas,M10,2013,4.8,70916,1413843,1484759
Kansas,M09,2013,4.9,72643,1409571,1482214
Kansas,M08,2013,5.5,81922,1401204,1483126
Kansas,M07,2013,5.9,88919,1419344,1508263
Kansas,M06,2013,5.8,86510,1417646,1504156
Kansas,M05,2013,5.3,79139,1402017,1481156
Kansas,M04,2013,5.1,75032,1405383,1480415
Kansas,M03,2013,5.6,83111,1396928,1480039
Kansas,M02,2013,5.8,85957,1396447,1482404
Kansas,M01,2013,6.1,90721,1392108,1482829
Kansas,M12,2012,5.2,77894,1408063,1485957
Kansas,M11,2012,5.1,75755,1413931,1489686
Kansas,M10,2012,5.3,78977,1412005,1490982
Kansas,M09,2012,5.2,77664,1402490,1480154
Kansas,M08,2012,5.9,86568,1392385,1478953
Kansas,M07,2012,6.2,93792,1409591,1503383
Kansas,M06,2012,6.0,90179,1411312,1501491
Kansas,M05,2012,5.6,82479,1394669,1477148
Kansas,M04,2012,5.5,81421,1393995,1475416
Kansas,M03,2012,6.1,89776,1389734,1479510
Kansas,M02,2012,6.3,92793,1389048,1481841
Kansas,M01,2012,6.4,93872,1384236,1478108
Kansas,M12,2011,5.7,84491,1397271,1481762
Kansas,M11,2011,5.7,85574,1405083,1490657
Kansas,M10,2011,6.0,89777,1402050,1491827
Kansas,M09,2011,6.2,92874,1394858,1487732
Kansas,M08,2011,6.6,98912,1389439,1488351
Kansas,M07,2011,6.8,102765,1406491,1509256
Kansas,M06,2011,6.7,100531,1403369,1503900
Kansas,M05,2011,6.4,94418,1389403,1483821
Kansas,M04,2011,6.3,93668,1390804,1484472
Kansas,M03,2011,6.9,103354,1385322,1488676
Kansas,M02,2011,7.2,107424,1383766,1491190
Kansas,M01,2011,7.4,110272,1381130,1491402
Kansas,M12,2010,6.4,96108,1395361,1491469
Kansas,M11,2010,6.7,99768,1399997,1499765
Kansas,M10,2010,6.7,100038,1398510,1498548
Kansas,M09,2010,6.8,102192,1393120,1495312
Kansas,M08,2010,7.2,108161,1390040,1498201
Kansas,M07,2010,7.4,112315,1409786,1522101
Kansas,M06,2010,7.1,107640,1410005,1517645
Kansas,M05,2010,6.8,101758,1393687,1495445
Kansas,M04,2010,6.9,102782,1395388,1498170
Kansas,M03,2010,7.5,111681,1383692,1495373
Kansas,M02,2010,7.5,111764,1384713,1496477
Kansas,M01,2010,7.7,115467,1385202,1500669
Kansas,M12,2009,6.8,102329,1400177,1502506
Kansas,M11,2009,6.6,99929,1412334,1512263
Kansas,M10,2009,6.9,104235,1409982,1514217
Kansas,M09,2009,7.2,109120,1405594,1514714
Kansas,M08,2009,7.3,111437,1405332,1516769
Kansas,M07,2009,7.9,122127,1428915,1551042
Kansas,M06,2009,7.2,111426,1429929,1541355
Kansas,M05,2009,6.9,105293,1413947,1519240
Kansas,M04,2009,6.5,97977,1418653,1516630
Kansas,M03,2009,6.5,98607,1411220,1509827
Kansas,M02,2009,6.3,95734,1414984,1510718
Kansas,M01,2009,6.2,93790,1415414,1509204
Kansas,M12,2008,5.0,75963,1432702,1508665
Kansas,M11,2008,4.8,72282,1440743,1513025
Kansas,M10,2008,4.7,71764,1439088,1510852
Kansas,M09,2008,4.7,70994,1430120,1501114
Kansas,M08,2008,5.0,74539,1424908,1499447
Kansas,M07,2008,4.9,75170,1447438,1522608
Kansas,M06,2008,4.6,69820,1446896,1516716
Kansas,M05,2008,4.3,63850,1427041,1490891
Kansas,M04,2008,3.8,56550,1429443,1485993
Kansas,M03,2008,4.4,65363,1419044,1484407
Kansas,M02,2008,4.4,64523,1416270,1480793
Kansas,M01,2008,4.6,67755,1413838,1481593
Kansas,M12,2007,4.1,61453,1426329,1487782
Kansas,M11,2007,4.0,59023,1434312,1493335
Kansas,M10,2007,4.1,60457,1429055,1489512
Kansas,M09,2007,4.2,61908,1421785,1483693
Kansas,M08,2007,4.3,64089,1415923,1480012
Kansas,M07,2007,4.6,69009,1438540,1507549
Kansas,M06,2007,4.4,65867,1436883,1502750
Kansas,M05,2007,4.1,59919,1414159,1474078
Kansas,M04,2007,3.9,56710,1413995,1470705
Kansas,M03,2007,4.3,62746,1409161,1471907
Kansas,M02,2007,4.6,67224,1404611,1471835
Kansas,M01,2007,4.6,67706,1400639,1468345
Kansas,M12,2006,3.9,57082,1416046,1473128
Kansas,M11,2006,4.0,59808,1417441,1477249
Kansas,M10,2006,4.1,59781,1414350,1474131
Kansas,M09,2006,4.2,61054,1403376,1464430
Kansas,M08,2006,4.6,66793,1397667,1464460
Kansas,M07,2006,4.8,70764,1416232,1486996
Kansas,M06,2006,4.5,66913,1417403,1484316
Kansas,M05,2006,4.1,60066,1396955,1457021
Kansas,M04,2006,4.1,60237,1396145,1456382
Kansas,M03,2006,4.6,67710,1388473,1456183
Kansas,M02,2006,4.8,69487,1386949,1456436
Kansas,M01,2006,4.9,71887,1382510,1454397
Kansas,M12,2005,4.3,63527,1397065,1460592
Kansas,M11,2005,4.7,69085,1400299,1469384
Kansas,M10,2005,4.6,68010,1398568,1466578
Kansas,M09,2005,4.8,69874,1388636,1458510
Kansas,M08,2005,5.0,73162,1386062,1459224
Kansas,M07,2005,5.3,78200,1406505,1484705
Kansas,M06,2005,5.1,76255,1407407,1483662
Kansas,M05,2005,4.9,70891,1389181,1460072
Kansas,M04,2005,4.8,70172,1389856,1460028
Kansas,M03,2005,5.4,78609,1382148,1460757
Kansas,M02,2005,5.6,81494,1380911,1462405
Kansas,M01,2005,5.8,84118,1377653,1461771
Kansas,M12,2004,4.9,71247,1392969,1464216
Kansas,M11,2004,5.1,74710,1397740,1472450
Kansas,M10,2004,5.1,75496,1394199,1469695
Kansas,M09,2004,5.3,77035,1386311,1463346
Kansas,M08,2004,5.5,81260,1384385,1465645
Kansas,M07,2004,5.7,85239,1404940,1490179
Kansas,M06,2004,5.6,83462,1399684,1483146
Kansas,M05,2004,5.3,76495,1378286,1454781
Kansas,M04,2004,5.2,75419,1376996,1452415
Kansas,M03,2004,5.8,84526,1367044,1451570
Kansas,M02,2004,5.9,85779,1364914,1450693
Kansas,M01,2004,6.0,87414,1358934,1446348
Kansas,M12,2003,5.2,75823,1368885,1444708
Kansas,M11,2003,5.4,78281,1370767,1449048
Kansas,M10,2003,5.4,78043,1364897,1442940
Kansas,M09,2003,5.5,79494,1354485,1433979
Kansas,M08,2003,5.7,82349,1351974,1434323
Kansas,M07,2003,6.2,89992,1371664,1461656
Kansas,M06,2003,6.0,86929,1371738,1458667
Kansas,M05,2003,5.2,73547,1351904,1425451
Kansas,M04,2003,5.0,71963,1353657,1425620
Kansas,M03,2003,5.4,76844,1346413,1423257
Kansas,M02,2003,5.4,76301,1346531,1422832
Kansas,M01,2003,5.7,80350,1341486,1421836
Kansas,M12,2002,4.5,64385,1352308,1416693
Kansas,M11,2002,4.9,69807,1353911,1423718
Kansas,M10,2002,4.9,69483,1353552,1423035
Kansas,M09,2002,4.9,69821,1346898,1416719
Kansas,M08,2002,5.2,73353,1341371,1414724
Kansas,M07,2002,5.5,79366,1358264,1437630
Kansas,M06,2002,5.2,74672,1355501,1430173
Kansas,M05,2002,4.7,66336,1336113,1402449
Kansas,M04,2002,4.7,66350,1334333,1400683
Kansas,M03,2002,5.2,73449,1325783,1399232
Kansas,M02,2002,5.2,72641,1325390,1398031
Kansas,M01,2002,5.5,77270,1315816,1393086
Kansas,M12,2001,4.2,58205,1331823,1390028
Kansas,M11,2001,4.4,61350,1334085,1395435
Kansas,M10,2001,4.2,58853,1333256,1392109
Kansas,M09,2001,4.2,57835,1325940,1383775
Kansas,M08,2001,4.4,61184,1319540,1380724
Kansas,M07,2001,4.4,62436,1346106,1408542
Kansas,M06,2001,4.3,60257,1344701,1404958
Kansas,M05,2001,3.8,51787,1327952,1379739
Kansas,M04,2001,3.7,50635,1331851,1382486
Kansas,M03,2001,4.3,59229,1329907,1389136
Kansas,M02,2001,4.2,58974,1330241,1389215
Kansas,M01,2001,4.5,62292,1329005,1391297
Kansas,M12,2000,3.3,45849,1345404,1391253
Kansas,M11,2000,3.6,49902,1347803,1397705
Kansas,M10,2000,3.6,50477,1347294,1397771
Kansas,M09,2000,3.6,50323,1340749,1391072
Kansas,M08,2000,3.8,53050,1343054,1396104
Kansas,M07,2000,3.9,54821,1367880,1422701
Kansas,M06,2000,3.6,52118,1376096,1428214
Kansas,M05,2000,3.4,47866,1357796,1405662
Kansas,M04,2000,3.2,45433,1365546,1410979
Kansas,M03,2000,3.7,52561,1359351,1411912
Kansas,M02,2000,3.6,50198,1361876,1412074
Kansas,M01,2000,3.7,52594,1360917,1413511
Wisconsin,M12,2016,3.7,114831,2983504,3098335
Wisconsin,M11,2016,3.7,113945,3002815,3116760
Wisconsin,M10,2016,3.7,114870,3012557,3127427
Wisconsin,M09,2016,3.8,117402,3009812,3127214
Wisconsin,M08,2016,4.0,125875,3018572,3144447
Wisconsin,M07,2016,4.2,131738,3032742,3164480
Wisconsin,M06,2016,4.5,141330,3023380,3164710
Wisconsin,M05,2016,3.8,119416,2987284,3106700
Wisconsin,M04,2016,4.1,127379,2970650,3098029
Wisconsin,M03,2016,4.7,146817,2956846,3103663
Wisconsin,M02,2016,4.9,152272,2954255,3106527
Wisconsin,M01,2016,4.7,144473,2939979,3084452
Wisconsin,M12,2015,4.1,127324,2969474,3096798
Wisconsin,M11,2015,4.1,125770,2975115,3100885
Wisconsin,M10,2015,3.9,120180,2980665,3100845
Wisconsin,M09,2015,3.9,120002,2969175,3089177
Wisconsin,M08,2015,4.2,130628,2978849,3109477
Wisconsin,M07,2015,4.6,142987,2988661,3131648
Wisconsin,M06,2015,4.8,151802,2983445,3135247
Wisconsin,M05,2015,4.6,140618,2948801,3089419
Wisconsin,M04,2015,4.5,137201,2930973,3068174
Wisconsin,M03,2015,5.3,162565,2907939,3070504
Wisconsin,M02,2015,5.5,170432,2907522,3077954
Wisconsin,M01,2015,5.4,165814,2902338,3068152
Wisconsin,M12,2014,4.6,140130,2933356,3073486
Wisconsin,M11,2014,4.5,139161,2950864,3090025
Wisconsin,M10,2014,4.4,136285,2961595,3097880
Wisconsin,M09,2014,4.6,141494,2946763,3088257
Wisconsin,M08,2014,5.1,159101,2947166,3106267
Wisconsin,M07,2014,5.5,170898,2958445,3129343
Wisconsin,M06,2014,5.6,175909,2949083,3124992
Wisconsin,M05,2014,5.3,164195,2905338,3069533
Wisconsin,M04,2014,5.6,171344,2886082,3057426
Wisconsin,M03,2014,6.6,202866,2865308,3068174
Wisconsin,M02,2014,6.8,209891,2857159,3067050
Wisconsin,M01,2014,6.4,196209,2852429,3048638
Wisconsin,M12,2013,6.0,184360,2881710,3066070
Wisconsin,M11,2013,6.0,183052,2893021,3076073
Wisconsin,M10,2013,5.9,180738,2890722,3071460
Wisconsin,M09,2013,5.9,181664,2901697,3083361
Wisconsin,M08,2013,6.3,196453,2904333,3100786
Wisconsin,M07,2013,6.7,210577,2920250,3130827
Wisconsin,M06,2013,7.1,221983,2912695,3134678
Wisconsin,M05,2013,6.5,199876,2873849,3073725
Wisconsin,M04,2013,7.1,217044,2851788,3068832
Wisconsin,M03,2013,7.6,230966,2827255,3058221
Wisconsin,M02,2013,7.9,243856,2825775,3069631
Wisconsin,M01,2013,7.9,240962,2816888,3057850
Wisconsin,M12,2012,6.6,203779,2862578,3066357
Wisconsin,M11,2012,6.2,190078,2878522,3068600
Wisconsin,M10,2012,6.0,183686,2892908,3076594
Wisconsin,M09,2012,6.1,187539,2879090,3066629
Wisconsin,M08,2012,6.9,211912,2873048,3084960
Wisconsin,M07,2012,7.3,228075,2888316,3116391
Wisconsin,M06,2012,7.5,235312,2890608,3125920
Wisconsin,M05,2012,6.9,212368,2856292,3068660
Wisconsin,M04,2012,7.0,214344,2836449,3050793
Wisconsin,M03,2012,7.9,240295,2816911,3057206
Wisconsin,M02,2012,8.2,252353,2810503,3062856
Wisconsin,M01,2012,7.9,239014,2803786,3042800
Wisconsin,M12,2011,6.9,210205,2852012,3062217
Wisconsin,M11,2011,6.7,205183,2864674,3069857
Wisconsin,M10,2011,6.7,206764,2871717,3078481
Wisconsin,M09,2011,7.0,215048,2864511,3079559
Wisconsin,M08,2011,7.5,232084,2868696,3100780
Wisconsin,M07,2011,7.8,244498,2872699,3117197
Wisconsin,M06,2011,8.2,256460,2865437,3121897
Wisconsin,M05,2011,7.7,235811,2833647,3069458
Wisconsin,M04,2011,7.9,243285,2819041,3062326
Wisconsin,M03,2011,8.8,269051,2799987,3069038
Wisconsin,M02,2011,9.1,278314,2792213,3070527
Wisconsin,M01,2011,8.8,268449,2787323,3055772
Wisconsin,M12,2010,7.7,236655,2822536,3059191
Wisconsin,M11,2010,7.7,235814,2830803,3066617
Wisconsin,M10,2010,7.4,227500,2841818,3069318
Wisconsin,M09,2010,7.5,231509,2840748,3072257
Wisconsin,M08,2010,8.2,253443,2849280,3102723
Wisconsin,M07,2010,8.5,264053,2854255,3118308
Wisconsin,M06,2010,8.7,270767,2849459,3120226
Wisconsin,M05,2010,8.5,261427,2812858,3074285
Wisconsin,M04,2010,9.0,276028,2802854,3078882
Wisconsin,M03,2010,10.3,315938,2761097,3077035
Wisconsin,M02,2010,10.4,321571,2755940,3077511
Wisconsin,M01,2010,10.1,310724,2751070,3061794
Wisconsin,M12,2009,8.9,272397,2787444,3059841
Wisconsin,M11,2009,8.3,254794,2815532,3070326
Wisconsin,M10,2009,8.2,251458,2823126,3074584
Wisconsin,M09,2009,8.1,250089,2826379,3076468
Wisconsin,M08,2009,8.6,269085,2852983,3122068
Wisconsin,M07,2009,8.8,277205,2875548,3152753
Wisconsin,M06,2009,9.0,285084,2872995,3158079
Wisconsin,M05,2009,8.5,263960,2835713,3099673
Wisconsin,M04,2009,8.7,268303,2831110,3099413
Wisconsin,M03,2009,9.3,287291,2812804,3100095
Wisconsin,M02,2009,8.8,274248,2831551,3105799
Wisconsin,M01,2009,7.7,238239,2846839,3085078
Wisconsin,M12,2008,6.0,186183,2904734,3090917
Wisconsin,M11,2008,5.2,161215,2934188,3095403
Wisconsin,M10,2008,4.5,141038,2959061,3100099
Wisconsin,M09,2008,4.3,133618,2955547,3089165
Wisconsin,M08,2008,4.7,146058,2966812,3112870
Wisconsin,M07,2008,4.7,146675,2989074,3135749
Wisconsin,M06,2008,4.8,148855,2984167,3133022
Wisconsin,M05,2008,4.3,130599,2941706,3072305
Wisconsin,M04,2008,4.5,138008,2931612,3069620
Wisconsin,M03,2008,5.2,158395,2908652,3067047
Wisconsin,M02,2008,5.5,167351,2902412,3069763
Wisconsin,M01,2008,5.2,158305,2907287,3065592
Wisconsin,M12,2007,4.5,137540,2941175,3078715
Wisconsin,M11,2007,4.2,129256,2956758,3086014
Wisconsin,M10,2007,4.1,126900,2957027,3083927
Wisconsin,M09,2007,4.3,134223,2954415,3088638
Wisconsin,M08,2007,4.7,144578,2958985,3103563
Wisconsin,M07,2007,4.9,153749,2981354,3135103
Wisconsin,M06,2007,5.1,161386,2975213,3136599
Wisconsin,M05,2007,4.7,143012,2925182,3068194
Wisconsin,M04,2007,5.2,160796,2906275,3067071
Wisconsin,M03,2007,5.6,172323,2898091,3070414
Wisconsin,M02,2007,6.0,182951,2891815,3074766
Wisconsin,M01,2007,5.5,169799,2891129,3060928
Wisconsin,M12,2006,4.5,138699,2938537,3077236
Wisconsin,M11,2006,4.3,131184,2939614,3070798
Wisconsin,M10,2006,3.9,119110,2950312,3069422
Wisconsin,M09,2006,4.1,126491,2933196,3059687
Wisconsin,M08,2006,4.5,137862,2947864,3085726
Wisconsin,M07,2006,4.7,145075,2958023,3103098
Wisconsin,M06,2006,4.9,152679,2950253,3102932
Wisconsin,M05,2006,4.5,137145,2900203,3037348
Wisconsin,M04,2006,4.9,147720,2881697,3029417
Wisconsin,M03,2006,5.6,169851,2860969,3030820
Wisconsin,M02,2006,5.8,174406,2856083,3030489
Wisconsin,M01,2006,5.2,157201,2853049,3010250
Wisconsin,M12,2005,4.5,135711,2892353,3028064
Wisconsin,M11,2005,4.4,131845,2895093,3026938
Wisconsin,M10,2005,3.9,119000,2909557,3028557
Wisconsin,M09,2005,4.1,124254,2897965,3022219
Wisconsin,M08,2005,4.3,129468,2915887,3045355
Wisconsin,M07,2005,4.6,142261,2923139,3065400
Wisconsin,M06,2005,4.9,149878,2910047,3059925
Wisconsin,M05,2005,4.5,135623,2865565,3001188
Wisconsin,M04,2005,4.8,143066,2848650,2991716
Wisconsin,M03,2005,5.5,165230,2824530,2989760
Wisconsin,M02,2005,5.9,175993,2826073,3002066
Wisconsin,M01,2005,5.5,163676,2828169,2991845
Wisconsin,M12,2004,4.4,130754,2873216,3003970
Wisconsin,M11,2004,4.2,127174,2889099,3016273
Wisconsin,M10,2004,4.0,122215,2897738,3019953
Wisconsin,M09,2004,4.1,124857,2892541,3017398
Wisconsin,M08,2004,4.6,139364,2914242,3053606
Wisconsin,M07,2004,4.9,151983,2930354,3082337
Wisconsin,M06,2004,5.3,162852,2917030,3079882
Wisconsin,M05,2004,4.9,147707,2872439,3020146
Wisconsin,M04,2004,5.3,158991,2858842,3017833
Wisconsin,M03,2004,6.3,190218,2842339,3032557
Wisconsin,M02,2004,6.3,191971,2849693,3041664
Wisconsin,M01,2004,6.0,182123,2847236,3029359
Wisconsin,M12,2003,4.9,149576,2886534,3036110
Wisconsin,M11,2003,4.9,148831,2896218,3045049
Wisconsin,M10,2003,4.7,142219,2902465,3044684
Wisconsin,M09,2003,5.0,151213,2889744,3040957
Wisconsin,M08,2003,5.5,167441,2897367,3064808
Wisconsin,M07,2003,5.8,178777,2910454,3089231
Wisconsin,M06,2003,6.2,192305,2912337,3104642
Wisconsin,M05,2003,5.5,168229,2869546,3037775
Wisconsin,M04,2003,6.0,183359,2861965,3045324
Wisconsin,M03,2003,6.7,204177,2844363,3048540
Wisconsin,M02,2003,6.8,207300,2846964,3054264
Wisconsin,M01,2003,6.4,192926,2839387,3032313
Wisconsin,M12,2002,5.1,154578,2874725,3029303
Wisconsin,M11,2002,4.9,147634,2879736,3027370
Wisconsin,M10,2002,4.4,133992,2898278,3032270
Wisconsin,M09,2002,4.5,135751,2891303,3027054
Wisconsin,M08,2002,5.0,151525,2889429,3040954
Wisconsin,M07,2002,5.3,161206,2896199,3057405
Wisconsin,M06,2002,5.6,171593,2890741,3062334
Wisconsin,M05,2002,5.0,151331,2850036,3001367
Wisconsin,M04,2002,5.7,172568,2829514,3002082
Wisconsin,M03,2002,6.4,194056,2814822,3008878
Wisconsin,M02,2002,6.5,196271,2819702,3015973
Wisconsin,M01,2002,6.1,181876,2804967,2986843
Wisconsin,M12,2001,4.8,144004,2855156,2999160
Wisconsin,M11,2001,4.6,139243,2864787,3004030
Wisconsin,M10,2001,4.1,122940,2883688,3006628
Wisconsin,M09,2001,3.9,117056,2886035,3003091
Wisconsin,M08,2001,4.3,129339,2889426,3018765
Wisconsin,M07,2001,4.4,133023,2919913,3052936
Wisconsin,M06,2001,4.8,146133,2909122,3055255
Wisconsin,M05,2001,4.1,123362,2872544,2995906
Wisconsin,M04,2001,4.6,138213,2860371,2998584
Wisconsin,M03,2001,5.1,154917,2855244,3010161
Wisconsin,M02,2001,5.1,151986,2855088,3007074
Wisconsin,M01,2001,4.5,133204,2855647,2988851
Wisconsin,M12,2000,3.3,99765,2885779,2985544
Wisconsin,M11,2000,3.2,95879,2882411,2978290
Wisconsin,M10,2000,2.8,81897,2886965,2968862
Wisconsin,M09,2000,3.0,88010,2875526,2963536
Wisconsin,M08,2000,3.5,104026,2889906,2993932
Wisconsin,M07,2000,3.7,110299,2901484,3011783
Wisconsin,M06,2000,3.9,118798,2904753,3023551
Wisconsin,M05,2000,3.3,98105,2852998,2951103
Wisconsin,M04,2000,3.4,101386,2852107,2953493
Wisconsin,M03,2000,4.2,124524,2831537,2956061
Wisconsin,M02,2000,4.2,123788,2831426,2955214
Wisconsin,M01,2000,3.8,111587,2825692,2937279
Tennessee,M12,2016,4.9,155435,3000705,3156140
Tennessee,M11,2016,4.7,148866,3008319,3157185
Tennessee,M10,2016,5.0,157787,3005054,3162841
Tennessee,M09,2016,5.2,164593,2996172,3160765
Tennessee,M08,2016,5.2,163305,2986295,3149600
Tennessee,M07,2016,5.2,163765,3010163,3173928
Tennessee,M06,2016,5.2,166315,3002626,3168941
Tennessee,M05,2016,4.2,130525,2989018,3119543
Tennessee,M04,2016,4.2,130382,2976063,3106445
Tennessee,M03,2016,4.5,139548,2965751,3105299
Tennessee,M02,2016,4.6,141482,2948104,3089586
Tennessee,M01,2016,4.8,148116,2922834,3070950
Tennessee,M12,2015,4.8,146609,2937068,3083677
Tennessee,M11,2015,4.9,150449,2930944,3081393
Tennessee,M10,2015,5.0,154215,2921825,3076040
Tennessee,M09,2015,5.3,161544,2900136,3061680
Tennessee,M08,2015,5.6,170659,2894247,3064906
Tennessee,M07,2015,6.0,187727,2916014,3103741
Tennessee,M06,2015,6.2,192525,2916470,3108995
Tennessee,M05,2015,5.8,177969,2908345,3086314
Tennessee,M04,2015,5.3,162859,2894569,3057428
Tennessee,M03,2015,5.7,174262,2872140,3046402
Tennessee,M02,2015,6.0,182538,2857145,3039683
Tennessee,M01,2015,6.6,200000,2841097,3041097
Tennessee,M12,2014,5.8,176442,2860739,3037181
Tennessee,M11,2014,6.0,183753,2865219,3048972
Tennessee,M10,2014,6.1,184929,2864894,3049823
Tennessee,M09,2014,6.4,194786,2841714,3036500
Tennessee,M08,2014,7.0,213679,2827749,3041428
Tennessee,M07,2014,7.3,226133,2856068,3082201
Tennessee,M06,2014,7.0,216043,2858698,3074741
Tennessee,M05,2014,6.3,192492,2846920,3039412
Tennessee,M04,2014,5.9,177646,2837497,3015143
Tennessee,M03,2014,6.8,207403,2828273,3035676
Tennessee,M02,2014,6.9,208917,2811337,3020254
Tennessee,M01,2014,6.7,201102,2798299,2999401
Tennessee,M12,2013,6.5,197475,2823133,3020608
Tennessee,M11,2013,6.8,207287,2830384,3037671
Tennessee,M10,2013,7.6,230851,2813471,3044322
Tennessee,M09,2013,7.6,233068,2827528,3060596
Tennessee,M08,2013,7.9,241592,2822326,3063918
Tennessee,M07,2013,8.1,252933,2856277,3109210
Tennessee,M06,2013,8.6,267566,2858203,3125769
Tennessee,M05,2013,7.8,242837,2853376,3096213
Tennessee,M04,2013,7.6,233201,2844544,3077745
Tennessee,M03,2013,8.0,245623,2826210,3071833
Tennessee,M02,2013,8.3,254623,2823264,3077887
Tennessee,M01,2013,8.7,268624,2815903,3084527
Tennessee,M12,2012,7.7,237531,2860870,3098401
Tennessee,M11,2012,7.1,217832,2871108,3088940
Tennessee,M10,2012,7.4,229972,2884352,3114324
Tennessee,M09,2012,7.4,228954,2866695,3095649
Tennessee,M08,2012,8.1,249778,2843971,3093749
Tennessee,M07,2012,8.5,266875,2871905,3138780
Tennessee,M06,2012,8.5,266527,2877393,3143920
Tennessee,M05,2012,7.7,238977,2867659,3106636
Tennessee,M04,2012,7.3,223613,2854546,3078159
Tennessee,M03,2012,7.9,243509,2844979,3088488
Tennessee,M02,2012,8.2,252567,2832364,3084931
Tennessee,M01,2012,8.3,256577,2819494,3076071
Tennessee,M12,2011,7.8,241584,2870868,3112452
Tennessee,M11,2011,7.8,242961,2874892,3117853
Tennessee,M10,2011,8.3,259293,2871058,3130351
Tennessee,M09,2011,8.9,278040,2852461,3130501
Tennessee,M08,2011,9.1,283975,2844492,3128467
Tennessee,M07,2011,9.1,286936,2856379,3143315
Tennessee,M06,2011,9.6,303073,2855103,3158176
Tennessee,M05,2011,8.9,277568,2850835,3128403
Tennessee,M04,2011,9.0,279731,2841354,3121085
Tennessee,M03,2011,9.5,296761,2825906,3122667
Tennessee,M02,2011,9.8,305044,2803528,3108572
Tennessee,M01,2011,10.1,312770,2789071,3101841
Tennessee,M12,2010,9.2,286253,2824342,3110595
Tennessee,M11,2010,9.3,289161,2821697,3110858
Tennessee,M10,2010,9.0,277832,2826224,3104056
Tennessee,M09,2010,9.0,279774,2820914,3100688
Tennessee,M08,2010,9.3,288952,2817433,3106385
Tennessee,M07,2010,9.3,288182,2823431,3111613
Tennessee,M06,2010,9.5,294960,2814535,3109495
Tennessee,M05,2010,9.3,288555,2799508,3088063
Tennessee,M04,2010,9.6,297864,2792964,3090828
Tennessee,M03,2010,10.6,323903,2743554,3067457
Tennessee,M02,2010,10.8,329113,2721796,3050909
Tennessee,M01,2010,11.2,340231,2698354,3038585
Tennessee,M12,2009,10.3,310397,2712192,3022589
Tennessee,M11,2009,9.9,298548,2730220,3028768
Tennessee,M10,2009,10.2,308524,2722112,3030636
Tennessee,M09,2009,10.4,315062,2712718,3027780
Tennessee,M08,2009,10.7,325276,2727786,3053062
Tennessee,M07,2009,11.0,340633,2756466,3097099
Tennessee,M06,2009,11.3,350574,2753734,3104308
Tennessee,M05,2009,10.6,324434,2739713,3064147
Tennessee,M04,2009,10.2,310985,2742609,3053594
Tennessee,M03,2009,10.9,333551,2725766,3059317
Tennessee,M02,2009,10.5,319282,2734412,3053694
Tennessee,M01,2009,9.8,297511,2739632,3037143
Tennessee,M12,2008,8.1,247985,2805596,3053581
Tennessee,M11,2008,7.2,221100,2830114,3051214
Tennessee,M10,2008,6.9,210282,2853838,3064120
Tennessee,M09,2008,6.9,211516,2843103,3054619
Tennessee,M08,2008,7.0,212699,2846387,3059086
Tennessee,M07,2008,7.0,216879,2882704,3099583
Tennessee,M06,2008,6.8,210350,2882390,3092740
Tennessee,M05,2008,6.1,185915,2866200,3052115
Tennessee,M04,2008,5.3,161447,2870802,3032249
Tennessee,M03,2008,5.9,178592,2858852,3037444
Tennessee,M02,2008,5.8,176111,2848739,3024850
Tennessee,M01,2008,5.9,179587,2856221,3035808
Tennessee,M12,2007,5.4,163998,2896953,3060951
Tennessee,M11,2007,5.0,152935,2919445,3072380
Tennessee,M10,2007,4.8,145648,2917592,3063240
Tennessee,M09,2007,4.8,148201,2915108,3063309
Tennessee,M08,2007,4.6,141444,2914604,3056048
Tennessee,M07,2007,4.6,141290,2955023,3096313
Tennessee,M06,2007,4.5,140474,2952175,3092649
Tennessee,M05,2007,4.0,122180,2930631,3052811
Tennessee,M04,2007,4.0,122398,2918061,3040459
Tennessee,M03,2007,4.4,135074,2923664,3058738
Tennessee,M02,2007,4.9,149075,2902861,3051936
Tennessee,M01,2007,5.1,157088,2898104,3055192
Tennessee,M12,2006,4.4,134989,2955736,3090725
Tennessee,M11,2006,4.6,143499,2944809,3088308
Tennessee,M10,2006,4.4,135394,2945857,3081251
Tennessee,M09,2006,4.9,149297,2903970,3053267
Tennessee,M08,2006,5.5,167424,2902696,3070120
Tennessee,M07,2006,5.8,178202,2912091,3090293
Tennessee,M06,2006,5.7,176671,2897498,3074169
Tennessee,M05,2006,5.1,154904,2862063,3016967
Tennessee,M04,2006,5.2,155919,2837020,2992939
Tennessee,M03,2006,5.5,162793,2814352,2977145
Tennessee,M02,2006,5.6,165232,2791745,2956977
Tennessee,M01,2006,5.7,166564,2773618,2940182
Tennessee,M12,2005,5.1,150828,2804750,2955578
Tennessee,M11,2005,5.3,156807,2789590,2946397
Tennessee,M10,2005,5.0,148148,2796361,2944509
Tennessee,M09,2005,4.8,138573,2765789,2904362
Tennessee,M08,2005,5.3,156167,2765320,2921487
Tennessee,M07,2005,5.5,160045,2773730,2933775
Tennessee,M06,2005,5.9,172794,2754102,2926896
Tennessee,M05,2005,5.5,158733,2731636,2890369
Tennessee,M04,2005,5.5,158334,2711157,2869491
Tennessee,M03,2005,6.0,172476,2686607,2859083
Tennessee,M02,2005,6.4,183235,2674718,2857953
Tennessee,M01,2005,6.3,180794,2666832,2847626
Tennessee,M12,2004,5.6,160918,2716576,2877494
Tennessee,M11,2004,5.5,159972,2725713,2885685
Tennessee,M10,2004,5.4,156963,2728218,2885181
Tennessee,M09,2004,5.3,151439,2711831,2863270
Tennessee,M08,2004,5.4,154195,2727793,2881988
Tennessee,M07,2004,5.3,153931,2755992,2909923
Tennessee,M06,2004,5.4,157361,2748742,2906103
Tennessee,M05,2004,4.6,131761,2731412,2863173
Tennessee,M04,2004,4.7,135139,2720753,2855892
Tennessee,M03,2004,5.6,160772,2712577,2873349
Tennessee,M02,2004,5.4,153546,2715219,2868765
Tennessee,M01,2004,5.8,167541,2706469,2874010
Tennessee,M12,2003,5.2,150433,2745448,2895881
Tennessee,M11,2003,5.6,164364,2746809,2911173
Tennessee,M10,2003,5.6,161576,2746508,2908084
Tennessee,M09,2003,5.5,158855,2727793,2886648
Tennessee,M08,2003,5.7,165170,2736673,2901843
Tennessee,M07,2003,5.9,174352,2761176,2935528
Tennessee,M06,2003,6.4,188810,2775495,2964305
Tennessee,M05,2003,5.3,154497,2758291,2912788
Tennessee,M04,2003,5.3,153206,2756778,2909984
Tennessee,M03,2003,5.6,163255,2746465,2909720
Tennessee,M02,2003,5.7,164776,2743369,2908145
Tennessee,M01,2003,5.8,169266,2732874,2902140
Tennessee,M12,2002,5.0,144452,2769707,2914159
Tennessee,M11,2002,4.8,139872,2765629,2905501
Tennessee,M10,2002,4.4,129786,2788561,2918347
Tennessee,M09,2002,4.5,129877,2781533,2911410
Tennessee,M08,2002,4.8,139227,2769593,2908820
Tennessee,M07,2002,5.1,148377,2783892,2932269
Tennessee,M06,2002,5.2,153800,2779209,2933009
Tennessee,M05,2002,4.5,131273,2762089,2893362
Tennessee,M04,2002,5.2,148797,2738119,2886916
Tennessee,M03,2002,6.0,172752,2728616,2901368
Tennessee,M02,2002,6.1,177957,2723631,2901588
Tennessee,M01,2002,6.6,189890,2682451,2872341
Tennessee,M12,2001,5.6,163003,2734262,2897265
Tennessee,M11,2001,5.5,157206,2724397,2881603
Tennessee,M10,2001,4.9,141612,2734163,2875775
Tennessee,M09,2001,4.5,129818,2723450,2853268
Tennessee,M08,2001,4.8,137574,2706012,2843586
Tennessee,M07,2001,4.4,126778,2755032,2881810
Tennessee,M06,2001,4.4,127005,2746858,2873863
Tennessee,M05,2001,3.6,100820,2736274,2837094
Tennessee,M04,2001,3.9,110824,2729659,2840483
Tennessee,M03,2001,4.3,122717,2738219,2860936
Tennessee,M02,2001,4.2,118606,2724185,2842791
Tennessee,M01,2001,4.5,128299,2719350,2847649
Tennessee,M12,2000,3.6,103271,2752912,2856183
Tennessee,M11,2000,3.9,111150,2733349,2844499
Tennessee,M10,2000,3.6,101126,2732402,2833528
Tennessee,M09,2000,3.8,105589,2708488,2814077
Tennessee,M08,2000,4.2,117812,2716139,2833951
Tennessee,M07,2000,3.9,112393,2741061,2853454
Tennessee,M06,2000,4.1,116671,2756303,2872974
Tennessee,M05,2000,3.5,99800,2728707,2828507
Tennessee,M04,2000,3.3,92744,2746330,2839074
Tennessee,M03,2000,4.0,114501,2734623,2849124
Tennessee,M02,2000,4.2,119757,2729935,2849692
Tennessee,M01,2000,4.3,122637,2719119,2841756
Nebraska,M12,2016,3.2,31903,975523,1007426
Nebraska,M11,2016,2.8,27976,982252,1010228
Nebraska,M10,2016,3.0,30561,980866,1011427
Nebraska,M09,2016,3.1,31006,972794,1003800
Nebraska,M08,2016,3.2,32821,980852,1013673
Nebraska,M07,2016,3.5,35980,990957,1026937
Nebraska,M06,2016,3.5,35621,987406,1023027
Nebraska,M05,2016,3.0,29932,983072,1013004
Nebraska,M04,2016,3.1,31031,980010,1011041
Nebraska,M03,2016,3.3,33719,974776,1008495
Nebraska,M02,2016,3.4,33976,970082,1004058
Nebraska,M01,2016,3.5,35162,964218,999380
Nebraska,M12,2015,3.0,29866,975368,1005234
Nebraska,M11,2015,2.7,27000,980482,1007482
Nebraska,M10,2015,2.8,28434,980598,1009032
Nebraska,M09,2015,2.9,28547,972464,1001011
Nebraska,M08,2015,3.1,31049,981588,1012637
Nebraska,M07,2015,3.5,35434,990446,1025880
Nebraska,M06,2015,3.3,33637,986747,1020384
Nebraska,M05,2015,2.9,29207,981931,1011138
Nebraska,M04,2015,2.9,28850,978898,1007748
Nebraska,M03,2015,3.1,31310,972025,1003335
Nebraska,M02,2015,3.2,31576,968416,999992
Nebraska,M01,2015,3.4,33716,963068,996784
Nebraska,M12,2014,2.8,28400,973891,1002291
Nebraska,M11,2014,2.6,25752,979470,1005222
Nebraska,M10,2014,2.7,27403,980217,1007620
Nebraska,M09,2014,2.9,28859,972189,1001048
Nebraska,M08,2014,3.1,31521,980701,1012222
Nebraska,M07,2014,3.7,38274,990325,1028599
Nebraska,M06,2014,3.5,35916,987744,1023660
Nebraska,M05,2014,3.1,31995,983797,1015792
Nebraska,M04,2014,3.2,32802,980852,1013654
Nebraska,M03,2014,4.0,40131,974961,1015092
Nebraska,M02,2014,3.9,39040,971331,1010371
Nebraska,M01,2014,4.0,39790,966020,1005810
Nebraska,M12,2013,3.4,34407,976282,1010689
Nebraska,M11,2013,3.1,31254,982371,1013625
Nebraska,M10,2013,3.3,33756,981611,1015367
Nebraska,M09,2013,3.4,34435,974758,1009193
Nebraska,M08,2013,3.6,37215,983560,1020775
Nebraska,M07,2013,4.2,42988,992808,1035796
Nebraska,M06,2013,4.1,42417,989485,1031902
Nebraska,M05,2013,3.7,38196,984943,1023139
Nebraska,M04,2013,3.8,38907,980717,1019624
Nebraska,M03,2013,4.1,41341,973779,1015120
Nebraska,M02,2013,4.3,43694,970136,1013830
Nebraska,M01,2013,4.5,45166,964837,1010003
Nebraska,M12,2012,3.9,39142,976150,1015292
Nebraska,M11,2012,3.5,35562,981733,1017295
Nebraska,M10,2012,3.6,36954,981144,1018098
Nebraska,M09,2012,3.7,36906,972501,1009407
Nebraska,M08,2012,3.9,39579,979386,1018965
Nebraska,M07,2012,4.3,44237,987884,1032121
Nebraska,M06,2012,4.2,42933,983723,1026656
Nebraska,M05,2012,3.8,38786,978071,1016857
Nebraska,M04,2012,3.9,39446,973306,1012752
Nebraska,M03,2012,4.3,43023,965849,1008872
Nebraska,M02,2012,4.5,44889,960030,1004919
Nebraska,M01,2012,4.5,45165,953354,998519
Nebraska,M12,2011,4.2,42053,963642,1005695
Nebraska,M11,2011,3.7,37341,968326,1005667
Nebraska,M10,2011,4.0,39842,966859,1006701
Nebraska,M09,2011,4.1,40853,957118,997971
Nebraska,M08,2011,4.3,43352,964131,1007483
Nebraska,M07,2011,4.6,46405,971990,1018395
Nebraska,M06,2011,4.7,47377,967027,1014404
Nebraska,M05,2011,4.3,43192,961357,1004549
Nebraska,M04,2011,4.3,43507,958171,1001678
Nebraska,M03,2011,4.8,47666,949116,996782
Nebraska,M02,2011,4.9,48709,943669,992378
Nebraska,M01,2011,5.1,50067,937296,987363
Nebraska,M12,2010,4.3,42449,948555,991004
Nebraska,M11,2010,4.1,40759,952998,993757
Nebraska,M10,2010,4.1,41019,953398,994417
Nebraska,M09,2010,4.2,41718,944168,985886
Nebraska,M08,2010,4.4,43586,952921,996507
Nebraska,M07,2010,4.7,47686,962073,1009759
Nebraska,M06,2010,4.9,48868,957401,1006269
Nebraska,M05,2010,4.5,44666,951096,995762
Nebraska,M04,2010,4.6,45261,947375,992636
Nebraska,M03,2010,5.2,50966,937821,988787
Nebraska,M02,2010,5.3,52214,933213,985427
Nebraska,M01,2010,5.4,53260,927304,980564
Nebraska,M12,2009,4.7,46063,938086,984149
Nebraska,M11,2009,4.3,42135,945676,987811
Nebraska,M10,2009,4.4,43285,946276,989561
Nebraska,M09,2009,4.6,45698,938527,984225
Nebraska,M08,2009,4.7,46543,948070,994613
Nebraska,M07,2009,4.9,49541,958910,1008451
Nebraska,M06,2009,4.8,48467,954411,1002878
Nebraska,M05,2009,4.6,46128,949802,995930
Nebraska,M04,2009,4.6,46017,948035,994052
Nebraska,M03,2009,4.7,46517,942251,988768
Nebraska,M02,2009,4.5,44794,940606,985400
Nebraska,M01,2009,4.7,46032,937125,983157
Nebraska,M12,2008,3.7,36836,951021,987857
Nebraska,M11,2008,3.3,32870,958314,991184
Nebraska,M10,2008,3.3,32877,960608,993485
Nebraska,M09,2008,3.2,31500,951780,983280
Nebraska,M08,2008,3.2,31946,960689,992635
Nebraska,M07,2008,3.5,35230,970286,1005516
Nebraska,M06,2008,3.5,34901,966814,1001715
Nebraska,M05,2008,3.1,30506,961771,992277
Nebraska,M04,2008,3.0,29207,958854,988061
Nebraska,M03,2008,3.3,32197,951470,983667
Nebraska,M02,2008,3.4,33371,947282,980653
Nebraska,M01,2008,3.5,34533,942222,976755
Nebraska,M12,2007,2.6,25487,950688,976175
Nebraska,M11,2007,2.9,28266,955925,984191
Nebraska,M10,2007,2.8,27353,955634,982987
Nebraska,M09,2007,2.8,27732,947224,974956
Nebraska,M08,2007,2.9,28091,955136,983227
Nebraska,M07,2007,3.3,32698,964073,996771
Nebraska,M06,2007,3.3,32910,959716,992626
Nebraska,M05,2007,3.0,29252,952382,981634
Nebraska,M04,2007,2.6,25625,947811,973436
Nebraska,M03,2007,2.9,27996,940225,968221
Nebraska,M02,2007,3.4,32761,935431,968192
Nebraska,M01,2007,3.4,33057,929678,962735
Nebraska,M12,2006,2.9,27794,940704,968498
Nebraska,M11,2006,2.7,26285,945298,971583
Nebraska,M10,2006,2.8,27243,944761,972004
Nebraska,M09,2006,2.9,27482,935786,963268
Nebraska,M08,2006,3.0,29031,943732,972763
Nebraska,M07,2006,3.4,33102,953222,986324
Nebraska,M06,2006,3.3,32379,949717,982096
Nebraska,M05,2006,3.0,28740,942540,971280
Nebraska,M04,2006,3.0,28954,938941,967895
Nebraska,M03,2006,3.3,31740,932688,964428
Nebraska,M02,2006,3.5,33806,928710,962516
Nebraska,M01,2006,3.7,35575,922387,957962
Nebraska,M12,2005,3.6,34570,933401,967971
Nebraska,M11,2005,3.3,32066,938998,971064
Nebraska,M10,2005,3.3,32571,939760,972331
Nebraska,M09,2005,3.4,33244,931071,964315
Nebraska,M08,2005,3.5,34480,940000,974480
Nebraska,M07,2005,3.9,39019,950052,989071
Nebraska,M06,2005,4.0,39329,945742,985071
Nebraska,M05,2005,3.7,36201,939825,976026
Nebraska,M04,2005,3.7,36505,937045,973550
Nebraska,M03,2005,4.2,40265,929961,970226
Nebraska,M02,2005,4.4,42336,925529,967865
Nebraska,M01,2005,4.6,44448,919490,963938
Nebraska,M12,2004,3.7,36121,931216,967337
Nebraska,M11,2004,3.5,33954,936522,970476
Nebraska,M10,2004,3.5,34425,937024,971449
Nebraska,M09,2004,3.7,35386,928813,964199
Nebraska,M08,2004,3.7,35700,937956,973656
Nebraska,M07,2004,4.0,39218,947683,986901
Nebraska,M06,2004,4.0,39693,942857,982550
Nebraska,M05,2004,3.7,35688,936518,972206
Nebraska,M04,2004,3.6,34978,932696,967674
Nebraska,M03,2004,4.1,39864,924286,964150
Nebraska,M02,2004,4.3,41615,919532,961147
Nebraska,M01,2004,4.5,42948,915079,958027
Nebraska,M12,2003,3.6,34867,925803,960670
Nebraska,M11,2003,3.5,33946,930435,964381
Nebraska,M10,2003,3.6,34439,930725,965164
Nebraska,M09,2003,3.7,35467,920670,956137
Nebraska,M08,2003,3.8,36455,929319,965774
Nebraska,M07,2003,4.2,41351,938749,980100
Nebraska,M06,2003,4.3,41841,936190,978031
Nebraska,M05,2003,3.9,37503,930481,967984
Nebraska,M04,2003,3.9,37253,927646,964899
Nebraska,M03,2003,4.2,40275,919290,959565
Nebraska,M02,2003,4.2,40474,915873,956347
Nebraska,M01,2003,4.4,41443,910600,952043
Nebraska,M12,2002,3.5,33510,919084,952594
Nebraska,M11,2002,3.3,31502,923044,954546
Nebraska,M10,2002,3.3,31043,923881,954924
Nebraska,M09,2002,3.4,31811,915562,947373
Nebraska,M08,2002,3.4,32831,923503,956334
Nebraska,M07,2002,3.8,37189,932726,969915
Nebraska,M06,2002,4.0,38231,929148,967379
Nebraska,M05,2002,3.5,33648,923321,956969
Nebraska,M04,2002,3.6,34244,919772,954016
Nebraska,M03,2002,3.9,37140,912343,949483
Nebraska,M02,2002,4.0,38240,908526,946766
Nebraska,M01,2002,4.1,38491,901903,940394
Nebraska,M12,2001,3.2,30759,916565,947324
Nebraska,M11,2001,3.0,28432,922516,950948
Nebraska,M10,2001,3.0,28298,922350,950648
Nebraska,M09,2001,2.9,27484,915338,942822
Nebraska,M08,2001,3.0,28470,925024,953494
Nebraska,M07,2001,3.3,32323,935318,967641
Nebraska,M06,2001,3.3,32202,932092,964294
Nebraska,M05,2001,2.9,27919,926217,954136
Nebraska,M04,2001,2.9,27886,922747,950633
Nebraska,M03,2001,3.2,30761,915815,946576
Nebraska,M02,2001,3.3,31003,911577,942580
Nebraska,M01,2001,3.4,31592,906473,938065
Nebraska,M12,2000,2.6,24395,916617,941012
Nebraska,M11,2000,2.6,24514,921221,945735
Nebraska,M10,2000,2.6,24383,921093,945476
Nebraska,M09,2000,2.6,24036,912586,936622
Nebraska,M08,2000,2.7,25724,922095,947819
Nebraska,M07,2000,3.0,28907,931804,960711
Nebraska,M06,2000,3.0,29150,929697,958847
Nebraska,M05,2000,2.8,26152,922518,948670
Nebraska,M04,2000,2.7,25214,919210,944424
Nebraska,M03,2000,3.0,27815,912933,940748
Nebraska,M02,2000,3.1,28744,908193,936937
Nebraska,M01,2000,3.2,30203,902475,932678
Florida,M12,2016,4.7,467212,9442395,9909607
Florida,M11,2016,4.8,473563,9453779,9927342
Florida,M10,2016,4.9,490603,9441449,9932052
Florida,M09,2016,5.1,508834,9437704,9946538
Florida,M08,2016,5.2,509388,9357967,9867355
Florida,M07,2016,5.1,508776,9371000,9879776
Florida,M06,2016,5.1,497771,9327298,9825069
Florida,M05,2016,4.5,445147,9374208,9819355
Florida,M04,2016,4.6,450261,9316298,9766559
Florida,M03,2016,4.8,466631,9324333,9790964
Florida,M02,2016,4.7,460727,9273313,9734040
Florida,M01,2016,5.0,485449,9183112,9668561
Florida,M12,2015,4.9,469345,9173209,9642554
Florida,M11,2015,5.0,486139,9140653,9626792
Florida,M10,2015,5.2,498168,9137921,9636089
Florida,M09,2015,5.4,515981,9114284,9630265
Florida,M08,2015,5.6,536825,9083809,9620634
Florida,M07,2015,5.8,557088,9094799,9651887
Florida,M06,2015,5.6,543327,9098708,9642035
Florida,M05,2015,5.5,531573,9164007,9695580
Florida,M04,2015,5.2,502591,9096109,9598700
Florida,M03,2015,5.4,515163,9054006,9569169
Florida,M02,2015,5.5,529139,9023677,9552816
Florida,M01,2015,5.9,564169,8993373,9557542
Florida,M12,2014,5.5,526208,9008195,9534403
Florida,M11,2014,5.8,558404,9032840,9591244
Florida,M10,2014,5.9,570852,9076173,9647025
Florida,M09,2014,6.2,602230,9039538,9641768
Florida,M08,2014,6.6,638495,8965128,9603623
Florida,M07,2014,6.7,644689,8998947,9643636
Florida,M06,2014,6.4,616487,8994915,9611402
Florida,M05,2014,6.3,605051,9020624,9625675
Florida,M04,2014,6.0,576595,8961978,9538573
Florida,M03,2014,6.5,626052,8945235,9571287
Florida,M02,2014,6.6,622271,8875646,9497917
Florida,M01,2014,6.7,630200,8818781,9448981
Florida,M12,2013,6.3,593159,8814607,9407766
Florida,M11,2013,6.6,619322,8812433,9431755
Florida,M10,2013,6.9,651689,8758404,9410093
Florida,M09,2013,7.1,679385,8850368,9529753
Florida,M08,2013,7.4,705116,8786440,9491556
Florida,M07,2013,7.6,722705,8807211,9529916
Florida,M06,2013,7.7,729810,8786468,9516278
Florida,M05,2013,7.2,684713,8833698,9518411
Florida,M04,2013,7.0,657955,8755285,9413240
Florida,M03,2013,7.2,676136,8691315,9367451
Florida,M02,2013,7.6,710978,8652488,9363466
Florida,M01,2013,8.2,773099,8606329,9379428
Florida,M12,2012,7.8,735933,8661278,9397211
Florida,M11,2012,7.8,730915,8670947,9401862
Florida,M10,2012,8.1,764746,8717550,9482296
Florida,M09,2012,8.3,787259,8694459,9481718
Florida,M08,2012,8.8,829830,8560484,9390314
Florida,M07,2012,9.1,858598,8582864,9441462
Florida,M06,2012,8.9,841419,8594714,9436133
Florida,M05,2012,8.4,792119,8634447,9426566
Florida,M04,2012,8.1,757997,8552791,9310788
Florida,M03,2012,8.5,787207,8526244,9313451
Florida,M02,2012,8.7,810363,8465493,9275856
Florida,M01,2012,9.0,835499,8402754,9238253
Florida,M12,2011,9.0,834614,8470393,9305007
Florida,M11,2011,9.1,846475,8469053,9315528
Florida,M10,2011,9.5,889933,8458802,9348735
Florida,M09,2011,9.9,934233,8455799,9390032
Florida,M08,2011,10.3,961702,8376294,9337996
Florida,M07,2011,10.7,995233,8340865,9336098
Florida,M06,2011,10.5,976692,8326024,9302716
Florida,M05,2011,9.9,922110,8407141,9329251
Florida,M04,2011,9.7,900377,8359987,9260364
Florida,M03,2011,10.1,934511,8326618,9261129
Florida,M02,2011,10.4,958435,8251530,9209965
Florida,M01,2011,10.8,992528,8217155,9209683
Florida,M12,2010,10.7,989605,8246471,9236076
Florida,M11,2010,11.1,1032098,8229809,9261907
Florida,M10,2010,10.9,1012849,8254352,9267201
Florida,M09,2010,11.1,1036129,8292618,9328747
Florida,M08,2010,11.5,1069651,8246578,9316229
Florida,M07,2010,11.4,1061374,8228895,9290269
Florida,M06,2010,11.0,1012445,8208789,9221234
Florida,M05,2010,10.5,965840,8260328,9226168
Florida,M04,2010,10.6,974509,8233652,9208161
Florida,M03,2010,11.0,1006869,8107376,9114245
Florida,M02,2010,11.2,1018112,8036129,9054241
Florida,M01,2010,11.5,1041406,7978905,9020311
Florida,M12,2009,11.1,996083,7981429,8977512
Florida,M11,2009,10.9,988736,8052935,9041671
Florida,M10,2009,11.1,1003589,8050281,9053870
Florida,M09,2009,11.1,1010453,8084924,9095377
Florida,M08,2009,11.1,1012048,8115570,9127618
Florida,M07,2009,11.0,1007348,8176631,9183979
Florida,M06,2009,10.8,985114,8161319,9146433
Florida,M05,2009,10.1,924241,8210043,9134284
Florida,M04,2009,9.5,867867,8232218,9100085
Florida,M03,2009,9.7,881011,8206707,9087718
Florida,M02,2009,9.5,861402,8234461,9095863
Florida,M01,2009,9.0,822526,8270952,9093478
Florida,M12,2008,8.1,740478,8423215,9163693
Florida,M11,2008,7.6,698579,8512164,9210743
Florida,M10,2008,7.3,673848,8598024,9271872
Florida,M09,2008,7.1,659033,8621074,9280107
Florida,M08,2008,7.2,664209,8609757,9273966
Florida,M07,2008,6.8,631543,8680572,9312115
Florida,M06,2008,6.2,571015,8680159,9251174
Florida,M05,2008,5.5,509946,8714898,9224844
Florida,M04,2008,4.8,443154,8727390,9170544
Florida,M03,2008,5.0,454615,8708828,9163443
Florida,M02,2008,4.8,441018,8674824,9115842
Florida,M01,2008,5.0,452879,8695061,9147940
Florida,M12,2007,4.7,426626,8741662,9168288
Florida,M11,2007,4.4,407341,8793112,9200453
Florida,M10,2007,4.4,404959,8774290,9179249
Florida,M09,2007,4.5,414185,8801095,9215280
Florida,M08,2007,4.5,409870,8757162,9167032
Florida,M07,2007,4.4,409948,8829348,9239296
Florida,M06,2007,4.1,377574,8820588,9198162
Florida,M05,2007,3.5,318110,8826786,9144896
Florida,M04,2007,3.3,301375,8786284,9087659
Florida,M03,2007,3.3,299029,8830206,9129235
Florida,M02,2007,3.4,309536,8767885,9077421
Florida,M01,2007,3.6,329698,8748822,9078520
Florida,M12,2006,3.2,290658,8847790,9138448
Florida,M11,2006,3.3,303974,8818167,9122141
Florida,M10,2006,3.2,290815,8828981,9119796
Florida,M09,2006,3.5,316811,8783791,9100602
Florida,M08,2006,3.6,329695,8756383,9086078
Florida,M07,2006,3.6,330808,8752088,9082896
Florida,M06,2006,3.4,305331,8724746,9030077
Florida,M05,2006,3.0,267733,8701168,8968901
Florida,M04,2006,2.8,250741,8636358,8887099
Florida,M03,2006,2.9,256666,8617493,8874159
Florida,M02,2006,3.1,269433,8548433,8817866
Florida,M01,2006,3.1,275513,8498862,8774375
Florida,M12,2005,3.0,265692,8544323,8810015
Florida,M11,2005,3.5,311487,8513085,8824572
Florida,M10,2005,3.4,297884,8545687,8843571
Florida,M09,2005,3.7,325550,8508088,8833638
Florida,M08,2005,3.7,326715,8494230,8820945
Florida,M07,2005,3.9,342810,8473956,8816766
Florida,M06,2005,3.9,339106,8402189,8741295
Florida,M05,2005,3.5,308750,8398971,8707721
Florida,M04,2005,3.5,305456,8327102,8632558
Florida,M03,2005,3.8,325166,8252806,8577972
Florida,M02,2005,4.1,352407,8186009,8538416
Florida,M01,2005,4.3,362923,8141236,8504159
Florida,M12,2004,4.2,358172,8194972,8553144
Florida,M11,2004,4.4,379605,8179546,8559151
Florida,M10,2004,4.6,389637,8150430,8540067
Florida,M09,2004,4.7,403380,8104338,8507718
Florida,M08,2004,4.8,406810,8092693,8499503
Florida,M07,2004,5.0,425351,8104622,8529973
Florida,M06,2004,5.0,421886,8036692,8458578
Florida,M05,2004,4.4,373439,8025667,8399106
Florida,M04,2004,4.3,360743,7978157,8338900
Florida,M03,2004,4.7,388409,7946052,8334461
Florida,M02,2004,4.6,377643,7918594,8296237
Florida,M01,2004,4.9,401164,7867138,8268302
Florida,M12,2003,4.5,368694,7889359,8258053
Florida,M11,2003,4.9,403315,7863432,8266747
Florida,M10,2003,4.9,406203,7852151,8258354
Florida,M09,2003,5.4,441712,7806889,8248601
Florida,M08,2003,5.6,463267,7775523,8238790
Florida,M07,2003,5.7,468390,7774816,8243206
Florida,M06,2003,5.8,480002,7773634,8253636
Florida,M05,2003,5.1,418903,7777669,8196572
Florida,M04,2003,4.9,401971,7758954,8160925
Florida,M03,2003,5.0,410636,7744556,8155192
Florida,M02,2003,5.2,421886,7714603,8136489
Florida,M01,2003,5.5,445592,7666192,8111784
Florida,M12,2002,5.2,426632,7700957,8127589
Florida,M11,2002,5.4,438827,7672572,8111399
Florida,M10,2002,5.3,436226,7743246,8179472
Florida,M09,2002,5.6,456576,7762509,8219085
Florida,M08,2002,5.9,484292,7690802,8175094
Florida,M07,2002,6.0,487998,7673315,8161313
Florida,M06,2002,5.9,480905,7647972,8128877
Florida,M05,2002,5.4,437325,7674322,8111647
Florida,M04,2002,5.5,443774,7609782,8053556
Florida,M03,2002,5.6,454974,7614440,8069414
Florida,M02,2002,5.7,460374,7601923,8062297
Florida,M01,2002,6.1,488815,7484352,7973167
Florida,M12,2001,5.8,469155,7580404,8049559
Florida,M11,2001,5.9,476113,7553761,8029874
Florida,M10,2001,5.8,470074,7593327,8063401
Florida,M09,2001,4.8,390060,7722518,8112578
Florida,M08,2001,5.0,400104,7656939,8057043
Florida,M07,2001,4.6,372619,7739901,8112520
Florida,M06,2001,4.5,362512,7702926,8065438
Florida,M05,2001,3.9,315166,7726050,8041216
Florida,M04,2001,3.9,316028,7697337,8013365
Florida,M03,2001,3.9,312674,7731492,8044166
Florida,M02,2001,3.7,297322,7681846,7979168
Florida,M01,2001,3.9,313332,7642907,7956239
Florida,M12,2000,3.3,264489,7693019,7957508
Florida,M11,2000,3.5,278970,7619664,7898634
Florida,M10,2000,3.6,285306,7618382,7903688
Florida,M09,2000,3.9,312109,7594629,7906738
Florida,M08,2000,4.2,333654,7588377,7922031
Florida,M07,2000,4.1,326284,7569708,7895992
Florida,M06,2000,4.0,319304,7566163,7885467
Florida,M05,2000,3.6,280011,7545858,7825869
Florida,M04,2000,3.3,254983,7554903,7809886
Florida,M03,2000,3.5,273276,7526861,7800137
Florida,M02,2000,3.5,274179,7484573,7758752
Florida,M01,2000,3.7,288400,7429636,7718036
Maine,M12,2016,3.5,24167,664542,688709
Maine,M11,2016,3.7,25518,665572,691090
Maine,M10,2016,3.4,23884,673843,697727
Maine,M09,2016,3.4,23693,671774,695467
Maine,M08,2016,3.3,23400,687551,710951
Maine,M07,2016,3.7,26109,684792,710901
Maine,M06,2016,3.8,26416,675642,702058
Maine,M05,2016,3.8,25865,660030,685895
Maine,M04,2016,4.0,27289,653058,680347
Maine,M03,2016,4.5,30469,647237,677706
Maine,M02,2016,4.7,31502,642633,674135
Maine,M01,2016,4.6,31061,641444,672505
Maine,M12,2015,3.8,25847,650648,676495
Maine,M11,2015,3.9,26473,649844,676317
Maine,M10,2015,3.5,23864,658990,682854
Maine,M09,2015,3.5,23869,656680,680549
Maine,M08,2015,3.5,24243,673036,697279
Maine,M07,2015,4.0,27769,671436,699205
Maine,M06,2015,4.2,29155,664026,693181
Maine,M05,2015,4.4,30262,650695,680957
Maine,M04,2015,4.8,32302,644166,676468
Maine,M03,2015,5.4,36619,639107,675726
Maine,M02,2015,5.7,38810,636366,675176
Maine,M01,2015,5.9,39879,638334,678213
Maine,M12,2014,5.1,34720,649906,684626
Maine,M11,2014,5.2,35515,650751,686266
Maine,M10,2014,4.7,32629,661418,694047
Maine,M09,2014,4.8,32974,659712,692686
Maine,M08,2014,4.7,33431,677023,710454
Maine,M07,2014,5.2,37275,676178,713453
Maine,M06,2014,5.3,37577,669863,707440
Maine,M05,2014,5.7,39353,655607,694960
Maine,M04,2014,6.2,43074,650097,693171
Maine,M03,2014,6.7,46491,647284,693775
Maine,M02,2014,7.1,49031,644433,693464
Maine,M01,2014,7.0,48823,645953,694776
Maine,M12,2013,6.0,42174,658297,700471
Maine,M11,2013,6.2,43385,660010,703395
Maine,M10,2013,5.6,39890,669996,709886
Maine,M09,2013,5.7,40132,668755,708887
Maine,M08,2013,5.6,40788,683290,724078
Maine,M07,2013,6.2,44898,681298,726196
Maine,M06,2013,6.4,46213,672093,718306
Maine,M05,2013,6.7,46897,657548,704445
Maine,M04,2013,7.2,50744,650092,700836
Maine,M03,2013,7.8,54158,643848,698006
Maine,M02,2013,8.2,56981,640018,696999
Maine,M01,2013,8.2,56941,639974,696915
Maine,M12,2012,7.1,50098,650583,700681
Maine,M11,2012,7.0,49059,650797,699856
Maine,M10,2012,6.5,46206,660257,706463
Maine,M09,2012,6.5,45547,656378,701925
Maine,M08,2012,6.5,46665,671251,717916
Maine,M07,2012,7.1,51407,668569,719976
Maine,M06,2012,7.3,51713,660800,712513
Maine,M05,2012,7.6,52886,645453,698339
Maine,M04,2012,8.0,55309,639267,694576
Maine,M03,2012,8.6,59835,634290,694125
Maine,M02,2012,8.8,61249,631478,692727
Maine,M01,2012,8.7,60257,632279,692536
Maine,M12,2011,7.6,53142,644010,697152
Maine,M11,2011,7.5,51925,644957,696882
Maine,M10,2011,7.0,48820,653267,702087
Maine,M09,2011,7.0,48628,650558,699186
Maine,M08,2011,6.9,49607,666420,716027
Maine,M07,2011,7.4,53225,663572,716797
Maine,M06,2011,7.7,54185,653860,708045
Maine,M05,2011,8.0,55774,638297,694071
Maine,M04,2011,8.5,58623,633307,691930
Maine,M03,2011,9.0,61963,628888,690851
Maine,M02,2011,9.3,63837,625488,689325
Maine,M01,2011,9.1,62628,626395,689023
Maine,M12,2010,8.0,55606,638391,693997
Maine,M11,2010,7.9,54769,639012,693781
Maine,M10,2010,7.3,50673,647994,698667
Maine,M09,2010,7.2,50193,644515,694708
Maine,M08,2010,7.2,51162,659426,710588
Maine,M07,2010,7.8,55261,655133,710394
Maine,M06,2010,7.9,55233,647647,702880
Maine,M05,2010,8.1,55618,634119,689737
Maine,M04,2010,8.5,58676,630170,688846
Maine,M03,2010,9.2,63282,623545,686827
Maine,M02,2010,9.5,64821,621095,685916
Maine,M01,2010,9.2,63326,622508,685834
Maine,M12,2009,8.1,55819,633983,689802
Maine,M11,2009,7.9,54451,636432,690883
Maine,M10,2009,7.3,50919,644822,695741
Maine,M09,2009,7.4,51235,642401,693636
Maine,M08,2009,7.3,51542,659294,710836
Maine,M07,2009,7.8,55803,656628,712431
Maine,M06,2009,8.1,56998,649250,706248
Maine,M05,2009,8.3,57246,635677,692923
Maine,M04,2009,8.5,59134,632679,691813
Maine,M03,2009,9.1,62551,627375,689926
Maine,M02,2009,8.9,61444,628422,689866
Maine,M01,2009,8.4,58035,632490,690525
Maine,M12,2008,6.8,47266,648191,695457
Maine,M11,2008,6.2,43327,652679,696006
Maine,M10,2008,5.4,37684,665274,702958
Maine,M09,2008,5.1,35529,663913,699442
Maine,M08,2008,4.8,34490,683048,717538
Maine,M07,2008,5.1,36928,683580,720508
Maine,M06,2008,5.0,35683,677094,712777
Maine,M05,2008,5.1,35279,662654,697933
Maine,M04,2008,5.3,37054,659550,696604
Maine,M03,2008,5.7,39362,654644,694006
Maine,M02,2008,5.8,39979,652679,692658
Maine,M01,2008,5.7,39276,654585,693861
Maine,M12,2007,4.7,32821,665617,698438
Maine,M11,2007,4.6,32188,666270,698458
Maine,M10,2007,4.3,30068,672790,702858
Maine,M09,2007,4.2,29619,669079,698698
Maine,M08,2007,4.0,28757,685272,714029
Maine,M07,2007,4.5,32085,684240,716325
Maine,M06,2007,4.4,31430,677281,708711
Maine,M05,2007,4.6,32118,661890,694008
Maine,M04,2007,4.9,33902,658757,692659
Maine,M03,2007,5.2,35744,657662,693406
Maine,M02,2007,5.4,37338,655786,693124
Maine,M01,2007,5.2,36170,658731,694901
Maine,M12,2006,4.4,30555,670998,701553
Maine,M11,2006,4.5,31426,670486,701912
Maine,M10,2006,4.1,28874,678348,707222
Maine,M09,2006,4.1,28600,673783,702383
Maine,M08,2006,4.0,28812,690310,719122
Maine,M07,2006,4.5,31954,686097,718051
Maine,M06,2006,4.4,31468,679218,710686
Maine,M05,2006,4.5,31084,664026,695110
Maine,M04,2006,4.6,31945,660129,692074
Maine,M03,2006,5.2,35629,655236,690865
Maine,M02,2006,5.4,36910,652285,689195
Maine,M01,2006,5.3,36584,653733,690317
Maine,M12,2005,4.5,31314,665437,696751
Maine,M11,2005,4.6,32113,665632,697745
Maine,M10,2005,4.3,30448,674440,704888
Maine,M09,2005,4.4,30619,670633,701252
Maine,M08,2005,4.2,30380,687069,717449
Maine,M07,2005,4.7,33566,683647,717213
Maine,M06,2005,4.7,33218,673978,707196
Maine,M05,2005,4.9,34040,657898,691938
Maine,M04,2005,5.2,35714,651295,687009
Maine,M03,2005,5.7,38667,644141,682808
Maine,M02,2005,5.8,39806,641438,681244
Maine,M01,2005,5.6,38372,641974,680346
Maine,M12,2004,4.7,31893,653789,685682
Maine,M11,2004,4.6,31590,655045,686635
Maine,M10,2004,4.2,28987,662647,691634
Maine,M09,2004,4.1,28350,659278,687628
Maine,M08,2004,3.9,27580,676304,703884
Maine,M07,2004,4.3,29987,673834,703821
Maine,M06,2004,4.3,29669,665030,694699
Maine,M05,2004,4.4,29547,649130,678677
Maine,M04,2004,4.8,32205,643336,675541
Maine,M03,2004,5.4,36584,638333,674917
Maine,M02,2004,5.6,38055,636357,674412
Maine,M01,2004,5.6,37621,636844,674465
Maine,M12,2003,4.8,32444,648423,680867
Maine,M11,2003,4.8,32962,649954,682916
Maine,M10,2003,4.5,30993,658573,689566
Maine,M09,2003,4.5,30753,655355,686108
Maine,M08,2003,4.3,29837,671701,701538
Maine,M07,2003,4.8,33536,668207,701743
Maine,M06,2003,4.8,33054,659488,692542
Maine,M05,2003,4.8,32802,644224,677026
Maine,M04,2003,5.3,36109,639113,675222
Maine,M03,2003,5.7,38069,634777,672846
Maine,M02,2003,5.8,39145,632285,671430
Maine,M01,2003,5.6,37864,632755,670619
Maine,M12,2002,4.6,30855,644332,675187
Maine,M11,2002,4.5,30301,644763,675064
Maine,M10,2002,3.9,26474,655261,681735
Maine,M09,2002,3.8,25805,652673,678478
Maine,M08,2002,3.6,25245,668207,693452
Maine,M07,2002,4.1,28387,665669,694056
Maine,M06,2002,4.2,28441,656739,685180
Maine,M05,2002,4.2,27914,641087,669001
Maine,M04,2002,4.5,30247,634907,665154
Maine,M03,2002,4.9,32608,630369,662977
Maine,M02,2002,4.9,32460,628527,660987
Maine,M01,2002,5.0,32821,628685,661506
Maine,M12,2001,4.0,26762,641784,668546
Maine,M11,2001,4.0,26612,644474,671086
Maine,M10,2001,3.6,24700,654591,679291
Maine,M09,2001,3.5,23474,652717,676191
Maine,M08,2001,3.3,22516,667819,690335
Maine,M07,2001,3.7,25588,666985,692573
Maine,M06,2001,3.7,25004,659513,684517
Maine,M05,2001,3.8,25454,644883,670337
Maine,M04,2001,4.0,26917,640188,667105
Maine,M03,2001,4.1,27223,636980,664203
Maine,M02,2001,4.3,28502,635193,663695
Maine,M01,2001,4.0,26538,637408,663946
Maine,M12,2000,3.1,20831,649360,670191
Maine,M11,2000,3.2,21744,650069,671813
Maine,M10,2000,2.7,18505,657780,676285
Maine,M09,2000,2.7,18338,656800,675138
Maine,M08,2000,2.6,18109,675352,693461
Maine,M07,2000,3.0,20726,674756,695482
Maine,M06,2000,3.1,21369,668148,689517
Maine,M05,2000,3.3,22183,653689,675872
Maine,M04,2000,3.6,24151,649516,673667
Maine,M03,2000,4.2,27949,645231,673180
Maine,M02,2000,4.4,29713,641732,671445
Maine,M01,2000,4.5,30156,641758,671914
Alaska,M12,2016,6.6,23311,332482,355793
Alaska,M11,2016,6.4,23006,333772,356778
Alaska,M10,2016,6.2,22232,335242,357474
Alaska,M09,2016,6.1,21892,338869,360761
Alaska,M08,2016,5.8,21301,345024,366325
Alaska,M07,2016,6.1,22540,348732,371272
Alaska,M06,2016,6.8,24922,342833,367755
Alaska,M05,2016,6.6,23829,337840,361669
Alaska,M04,2016,6.8,24232,332108,356340
Alaska,M03,2016,7.2,25741,331489,357230
Alaska,M02,2016,7.5,26762,330577,357339
Alaska,M01,2016,7.3,25900,330476,356376
Alaska,M12,2015,6.6,23522,333736,357258
Alaska,M11,2015,6.5,23265,335310,358575
Alaska,M10,2015,6.1,22001,338162,360163
Alaska,M09,2015,5.8,21048,341883,362931
Alaska,M08,2015,5.5,20369,347786,368155
Alaska,M07,2015,5.8,21718,351895,373613
Alaska,M06,2015,6.5,24194,346334,370528
Alaska,M05,2015,6.3,23010,341011,364021
Alaska,M04,2015,6.6,23522,334692,358214
Alaska,M03,2015,7.1,25426,334051,359477
Alaska,M02,2015,7.3,26386,333321,359707
Alaska,M01,2015,7.2,25798,333515,359313
Alaska,M12,2014,6.5,23346,336253,359599
Alaska,M11,2014,6.5,23452,337743,361195
Alaska,M10,2014,6.2,22382,340247,362629
Alaska,M09,2014,6.2,22747,343253,366000
Alaska,M08,2014,6.0,22404,349182,371586
Alaska,M07,2014,6.4,23982,353059,377041
Alaska,M06,2014,7.0,26240,347422,373662
Alaska,M05,2014,6.8,25067,342265,367332
Alaska,M04,2014,7.1,25835,335650,361485
Alaska,M03,2014,7.6,27637,334415,362052
Alaska,M02,2014,8.0,28795,333145,361940
Alaska,M01,2014,7.8,28037,333231,361268
Alaska,M12,2013,7.0,25217,336156,361373
Alaska,M11,2013,6.9,25174,337737,362911
Alaska,M10,2013,6.6,23826,339498,363324
Alaska,M09,2013,6.2,22722,343812,366534
Alaska,M08,2013,5.9,22054,349259,371313
Alaska,M07,2013,6.2,23445,352122,375567
Alaska,M06,2013,7.0,26143,346108,372251
Alaska,M05,2013,6.9,25133,340410,365543
Alaska,M04,2013,7.1,25490,334211,359701
Alaska,M03,2013,7.5,26963,333378,360341
Alaska,M02,2013,7.9,28370,332337,360707
Alaska,M01,2013,7.9,28394,331752,360146
Alaska,M12,2012,7.2,25938,335716,361654
Alaska,M11,2012,6.9,24904,337697,362601
Alaska,M10,2012,6.4,23458,340765,364223
Alaska,M09,2012,6.3,22912,342860,365772
Alaska,M08,2012,6.1,22532,348035,370567
Alaska,M07,2012,6.5,24262,351396,375658
Alaska,M06,2012,7.2,26794,345914,372708
Alaska,M05,2012,7.1,26098,340194,366292
Alaska,M04,2012,7.5,26992,333850,360842
Alaska,M03,2012,8.0,28912,333448,362360
Alaska,M02,2012,8.3,29994,332212,362206
Alaska,M01,2012,8.2,29740,331598,361338
Alaska,M12,2011,7.8,28299,335281,363580
Alaska,M11,2011,7.4,27115,337109,364224
Alaska,M10,2011,7.0,25385,339254,364639
Alaska,M09,2011,6.7,24616,343090,367706
Alaska,M08,2011,6.6,24386,347831,372217
Alaska,M07,2011,6.8,25571,350908,376479
Alaska,M06,2011,7.6,28269,344507,372776
Alaska,M05,2011,7.4,27203,338092,365295
Alaska,M04,2011,7.9,28389,331879,360268
Alaska,M03,2011,8.4,30468,331035,361503
Alaska,M02,2011,8.8,31843,329668,361511
Alaska,M01,2011,8.7,31477,329278,360755
Alaska,M12,2010,8.0,28778,331980,360758
Alaska,M11,2010,7.7,27892,332972,360864
Alaska,M10,2010,7.3,26229,334693,360922
Alaska,M09,2010,7.0,25363,337676,363039
Alaska,M08,2010,6.8,24853,342908,367761
Alaska,M07,2010,7.0,26171,346189,372360
Alaska,M06,2010,7.8,28830,339709,368539
Alaska,M05,2010,7.8,28250,333227,361477
Alaska,M04,2010,8.3,29494,327165,356659
Alaska,M03,2010,8.9,31867,325535,357402
Alaska,M02,2010,9.1,32632,324429,357061
Alaska,M01,2010,8.9,31605,324513,356118
Alaska,M12,2009,8.0,28479,327488,355967
Alaska,M11,2009,8.0,28621,329248,357869
Alaska,M10,2009,7.6,27366,331145,358511
Alaska,M09,2009,7.2,26042,334458,360500
Alaska,M08,2009,6.9,25174,340869,366043
Alaska,M07,2009,7.1,26347,344644,370991
Alaska,M06,2009,7.9,29041,338301,367342
Alaska,M05,2009,7.7,27814,332592,360406
Alaska,M04,2009,7.9,28141,326884,355025
Alaska,M03,2009,8.3,29333,325752,355085
Alaska,M02,2009,8.3,29620,325120,354740
Alaska,M01,2009,8.0,28281,325006,353287
Alaska,M12,2008,7.0,24638,328635,353273
Alaska,M11,2008,6.8,23955,329999,353954
Alaska,M10,2008,6.3,22324,332386,354710
Alaska,M09,2008,5.9,21227,335832,357059
Alaska,M08,2008,5.8,20912,341996,362908
Alaska,M07,2008,6.0,22082,345674,367756
Alaska,M06,2008,6.7,24546,339615,364161
Alaska,M05,2008,6.6,23718,333900,357618
Alaska,M04,2008,6.9,24331,326620,350951
Alaska,M03,2008,7.3,25771,325322,351093
Alaska,M02,2008,7.6,26634,323934,350568
Alaska,M01,2008,7.4,25755,323512,349267
Alaska,M12,2007,6.5,22816,325873,348689
Alaska,M11,2007,6.3,21976,327362,349338
Alaska,M10,2007,5.8,20396,329290,349686
Alaska,M09,2007,5.6,19825,332078,351903
Alaska,M08,2007,5.4,19082,337559,356641
Alaska,M07,2007,5.6,20409,340854,361263
Alaska,M06,2007,6.4,22759,335095,357854
Alaska,M05,2007,6.2,21858,329103,350961
Alaska,M04,2007,6.5,22544,322546,345090
Alaska,M03,2007,7.1,24449,321884,346333
Alaska,M02,2007,7.3,25234,320855,346089
Alaska,M01,2007,7.3,25129,320450,345579
Alaska,M12,2006,6.6,22828,323949,346777
Alaska,M11,2006,6.4,22148,325226,347374
Alaska,M10,2006,6.0,20839,327086,347925
Alaska,M09,2006,5.7,20077,330615,350692
Alaska,M08,2006,5.5,19730,336477,356207
Alaska,M07,2006,5.8,20982,339922,360904
Alaska,M06,2006,6.5,23356,334881,358237
Alaska,M05,2006,6.6,23194,327532,350726
Alaska,M04,2006,7.0,24136,320513,344649
Alaska,M03,2006,7.5,25979,319103,345082
Alaska,M02,2006,7.9,27369,317107,344476
Alaska,M01,2006,7.9,27154,316098,343252
Alaska,M12,2005,7.1,24332,318779,343111
Alaska,M11,2005,6.9,23875,320198,344073
Alaska,M10,2005,6.4,22181,322314,344495
Alaska,M09,2005,6.0,20936,325126,346062
Alaska,M08,2005,5.7,20035,331088,351123
Alaska,M07,2005,6.0,21400,334203,355603
Alaska,M06,2005,6.8,23892,327247,351139
Alaska,M05,2005,6.7,23124,321585,344709
Alaska,M04,2005,7.0,23866,314727,338593
Alaska,M03,2005,7.7,26133,312889,339022
Alaska,M02,2005,8.2,27829,311204,339033
Alaska,M01,2005,8.1,27374,310375,337749
Alaska,M12,2004,7.3,24663,312738,337401
Alaska,M11,2004,7.2,24370,312972,337342
Alaska,M10,2004,6.8,22971,314684,337655
Alaska,M09,2004,6.5,21998,316675,338673
Alaska,M08,2004,6.2,21394,321354,342748
Alaska,M07,2004,6.5,22634,324397,347031
Alaska,M06,2004,7.6,26143,317153,343296
Alaska,M05,2004,7.4,24705,310524,335229
Alaska,M04,2004,7.8,25796,304144,329940
Alaska,M03,2004,8.5,28065,302711,330776
Alaska,M02,2004,8.9,29448,301187,330635
Alaska,M01,2004,8.8,29017,301172,330189
Alaska,M12,2003,8.0,26271,303587,329858
Alaska,M11,2003,7.8,25787,304377,330164
Alaska,M10,2003,7.2,23941,306291,330232
Alaska,M09,2003,6.9,22942,308852,331794
Alaska,M08,2003,6.7,22657,314185,336842
Alaska,M07,2003,7.1,24224,317359,341583
Alaska,M06,2003,7.9,26743,311940,338683
Alaska,M05,2003,7.7,25715,306425,332140
Alaska,M04,2003,8.2,26769,299801,326570
Alaska,M03,2003,8.7,28389,299400,327789
Alaska,M02,2003,9.0,29410,298536,327946
Alaska,M01,2003,8.7,28506,297921,326427
Alaska,M12,2002,7.7,25103,300809,325912
Alaska,M11,2002,7.4,24112,301592,325704
Alaska,M10,2002,6.9,22511,303921,326432
Alaska,M09,2002,6.6,21782,306329,328111
Alaska,M08,2002,6.3,21089,311315,332404
Alaska,M07,2002,6.6,22293,314215,336508
Alaska,M06,2002,7.4,24711,308115,332826
Alaska,M05,2002,7.2,23312,302433,325745
Alaska,M04,2002,7.6,24382,296399,320781
Alaska,M03,2002,8.0,25713,296146,321859
Alaska,M02,2002,8.0,25827,295535,321362
Alaska,M01,2002,7.8,25012,294149,319161
Alaska,M12,2001,6.8,21720,297214,318934
Alaska,M11,2001,6.5,20931,298729,319660
Alaska,M10,2001,5.9,18762,301462,320224
Alaska,M09,2001,5.5,17872,304755,322627
Alaska,M08,2001,5.3,17369,310254,327623
Alaska,M07,2001,5.6,18707,313920,332627
Alaska,M06,2001,6.5,21399,307141,328540
Alaska,M05,2001,6.4,20706,301386,322092
Alaska,M04,2001,6.7,21030,295069,316099
Alaska,M03,2001,7.1,22481,294017,316498
Alaska,M02,2001,7.4,23402,292869,316271
Alaska,M01,2001,7.5,23565,291956,315521
Alaska,M12,2000,6.5,20591,295728,316319
Alaska,M11,2000,6.3,20033,296419,316452
Alaska,M10,2000,5.8,18420,298635,317055
Alaska,M09,2000,5.6,17796,301542,319338
Alaska,M08,2000,5.2,17017,308023,325040
Alaska,M07,2000,5.5,18212,311973,330185
Alaska,M06,2000,6.4,21094,306267,327361
Alaska,M05,2000,6.4,20446,300227,320673
Alaska,M04,2000,6.7,21092,293963,315055
Alaska,M03,2000,7.2,22604,293121,315725
Alaska,M02,2000,7.5,23708,292014,315722
Alaska,M01,2000,7.4,23372,291836,315208
Mississippi,M12,2016,5.7,73153,1216146,1289299
Mississippi,M11,2016,5.0,64314,1217553,1281867
Mississippi,M10,2016,5.7,73056,1214034,1287090
Mississippi,M09,2016,5.7,72753,1209355,1282108
Mississippi,M08,2016,5.6,71743,1201022,1272765
Mississippi,M07,2016,6.4,82624,1209849,1292473
Mississippi,M06,2016,6.8,87736,1204528,1292264
Mississippi,M05,2016,5.9,75602,1203488,1279090
Mississippi,M04,2016,5.2,65405,1202673,1268078
Mississippi,M03,2016,5.6,71300,1201791,1273091
Mississippi,M02,2016,5.9,75774,1199097,1274871
Mississippi,M01,2016,6.5,82377,1189817,1272194
Mississippi,M12,2015,6.5,84622,1207579,1292201
Mississippi,M11,2015,5.9,75592,1205743,1281335
Mississippi,M10,2015,6.0,76935,1202679,1279614
Mississippi,M09,2015,6.0,76338,1197894,1274232
Mississippi,M08,2015,5.9,75153,1192449,1267602
Mississippi,M07,2015,6.9,88486,1200330,1288816
Mississippi,M06,2015,7.2,92123,1194723,1286846
Mississippi,M05,2015,6.8,86318,1190209,1276527
Mississippi,M04,2015,5.7,71326,1182276,1253602
Mississippi,M03,2015,6.1,76128,1172007,1248135
Mississippi,M02,2015,6.5,81403,1165022,1246425
Mississippi,M01,2015,7.4,91668,1152192,1243860
Mississippi,M12,2014,6.8,85085,1168630,1253715
Mississippi,M11,2014,6.4,80040,1166986,1247026
Mississippi,M10,2014,6.9,85741,1162949,1248690
Mississippi,M09,2014,7.0,87373,1155765,1243138
Mississippi,M08,2014,7.4,91339,1147590,1238929
Mississippi,M07,2014,8.3,105328,1156977,1262305
Mississippi,M06,2014,8.4,105565,1155014,1260579
Mississippi,M05,2014,7.9,98278,1150440,1248718
Mississippi,M04,2014,6.8,83461,1149219,1232680
Mississippi,M03,2014,7.8,97212,1144927,1242139
Mississippi,M02,2014,8.1,101008,1139680,1240688
Mississippi,M01,2014,8.7,108317,1135243,1243560
Mississippi,M12,2013,7.8,97082,1154541,1251623
Mississippi,M11,2013,7.6,94744,1157544,1252288
Mississippi,M10,2013,8.3,104778,1151057,1255835
Mississippi,M09,2013,8.2,103707,1158865,1262572
Mississippi,M08,2013,8.3,104070,1153564,1257634
Mississippi,M07,2013,9.0,115847,1166380,1282227
Mississippi,M06,2013,9.5,123122,1166833,1289955
Mississippi,M05,2013,8.9,113380,1166919,1280299
Mississippi,M04,2013,7.9,100356,1167703,1268059
Mississippi,M03,2013,8.4,107180,1163857,1271037
Mississippi,M02,2013,9.1,117107,1163127,1280234
Mississippi,M01,2013,10.0,129105,1155736,1284841
Mississippi,M12,2012,8.9,115837,1184105,1299942
Mississippi,M11,2012,8.0,103568,1189867,1293435
Mississippi,M10,2012,8.8,115775,1195725,1311500
Mississippi,M09,2012,8.7,114405,1195609,1310014
Mississippi,M08,2012,9.0,117335,1190467,1307802
Mississippi,M07,2012,9.8,131342,1202595,1333937
Mississippi,M06,2012,9.8,131361,1204915,1336276
Mississippi,M05,2012,8.9,118634,1207626,1326260
Mississippi,M04,2012,8.0,104902,1207697,1312599
Mississippi,M03,2012,8.5,112431,1206204,1318635
Mississippi,M02,2012,9.3,122702,1201822,1324524
Mississippi,M01,2012,10.0,131791,1191717,1323508
Mississippi,M12,2011,9.4,125815,1214212,1340027
Mississippi,M11,2011,9.1,121039,1215487,1336526
Mississippi,M10,2011,9.8,132384,1212124,1344508
Mississippi,M09,2011,9.9,132354,1210286,1342640
Mississippi,M08,2011,9.8,131074,1204057,1335131
Mississippi,M07,2011,10.6,144142,1213386,1357528
Mississippi,M06,2011,10.9,148187,1211983,1360170
Mississippi,M05,2011,10.2,137080,1212674,1349754
Mississippi,M04,2011,9.3,124968,1211942,1336910
Mississippi,M03,2011,9.8,131410,1207866,1339276
Mississippi,M02,2011,10.4,139934,1199670,1339604
Mississippi,M01,2011,10.5,140342,1191281,1331623
Mississippi,M12,2010,10.3,139813,1216699,1356512
Mississippi,M11,2010,9.8,132044,1213597,1345641
Mississippi,M10,2010,9.7,130843,1211350,1342193
Mississippi,M09,2010,9.8,131491,1207862,1339353
Mississippi,M08,2010,9.6,127494,1199800,1327294
Mississippi,M07,2010,10.8,145933,1199914,1345847
Mississippi,M06,2010,10.6,140280,1178535,1318815
Mississippi,M05,2010,10.4,131358,1135715,1267073
Mississippi,M04,2010,9.8,124204,1136809,1261013
Mississippi,M03,2010,10.8,135423,1122958,1258381
Mississippi,M02,2010,11.3,142200,1117839,1260039
Mississippi,M01,2010,11.7,147665,1109475,1257140
Mississippi,M12,2009,10.7,135679,1129730,1265409
Mississippi,M11,2009,9.7,121823,1136371,1258194
Mississippi,M10,2009,10.0,125705,1131344,1257049
Mississippi,M09,2009,9.8,122485,1133075,1255560
Mississippi,M08,2009,9.4,118496,1136477,1254973
Mississippi,M07,2009,9.9,127132,1153020,1280152
Mississippi,M06,2009,9.9,127016,1154471,1281487
Mississippi,M05,2009,9.4,119682,1157169,1276851
Mississippi,M04,2009,8.5,108045,1163308,1271353
Mississippi,M03,2009,8.8,111668,1161377,1273045
Mississippi,M02,2009,8.9,114198,1166193,1280391
Mississippi,M01,2009,8.7,111537,1164629,1276166
Mississippi,M12,2008,7.6,98955,1197269,1296224
Mississippi,M11,2008,6.4,82683,1205975,1288658
Mississippi,M10,2008,6.8,88697,1210246,1298943
Mississippi,M09,2008,6.9,89270,1208362,1297632
Mississippi,M08,2008,6.7,86724,1208332,1295056
Mississippi,M07,2008,7.5,98605,1223946,1322551
Mississippi,M06,2008,7.1,94221,1228410,1322631
Mississippi,M05,2008,6.5,84969,1231911,1316880
Mississippi,M04,2008,5.1,66712,1239286,1305998
Mississippi,M03,2008,5.8,75569,1236476,1312045
Mississippi,M02,2008,5.9,78004,1233055,1311059
Mississippi,M01,2008,6.5,84966,1228619,1313585
Mississippi,M12,2007,6.1,81587,1248942,1330529
Mississippi,M11,2007,5.3,69801,1248881,1318682
Mississippi,M10,2007,5.7,75212,1236963,1312175
Mississippi,M09,2007,5.9,77108,1231241,1308349
Mississippi,M08,2007,5.6,72619,1220834,1293453
Mississippi,M07,2007,6.7,88155,1229605,1317760
Mississippi,M06,2007,6.7,87490,1223350,1310840
Mississippi,M05,2007,6.0,77413,1217562,1294975
Mississippi,M04,2007,5.6,72694,1214247,1286941
Mississippi,M03,2007,6.0,77243,1212794,1290037
Mississippi,M02,2007,6.6,85850,1205809,1291659
Mississippi,M01,2007,6.9,88289,1198483,1286772
Mississippi,M12,2006,6.3,82625,1226744,1309369
Mississippi,M11,2006,5.9,77083,1221666,1298749
Mississippi,M10,2006,5.9,76066,1217934,1294000
Mississippi,M09,2006,6.1,78412,1208301,1286713
Mississippi,M08,2006,6.2,79430,1205024,1284454
Mississippi,M07,2006,7.2,93627,1210987,1304614
Mississippi,M06,2006,7.0,90975,1210009,1300984
Mississippi,M05,2006,6.3,80332,1204544,1284876
Mississippi,M04,2006,5.9,74629,1200913,1275542
Mississippi,M03,2006,6.2,79274,1196911,1276185
Mississippi,M02,2006,7.5,96694,1189814,1286508
Mississippi,M01,2006,8.0,102028,1178019,1280047
Mississippi,M12,2005,7.9,103046,1200318,1303364
Mississippi,M11,2005,8.7,114346,1198008,1312354
Mississippi,M10,2005,9.1,118761,1193385,1312146
Mississippi,M09,2005,9.8,128614,1183479,1312093
Mississippi,M08,2005,6.3,83310,1232313,1315623
Mississippi,M07,2005,6.9,92788,1243253,1336041
Mississippi,M06,2005,7.4,99487,1237209,1336696
Mississippi,M05,2005,6.7,89235,1236182,1325417
Mississippi,M04,2005,6.1,80537,1235237,1315774
Mississippi,M03,2005,6.5,85351,1228868,1314219
Mississippi,M02,2005,7.0,92378,1223778,1316156
Mississippi,M01,2005,7.3,94947,1213868,1308815
Mississippi,M12,2004,6.7,88125,1236450,1324575
Mississippi,M11,2004,6.2,82302,1234793,1317095
Mississippi,M10,2004,6.6,86833,1230865,1317698
Mississippi,M09,2004,6.2,81215,1227114,1308329
Mississippi,M08,2004,6.2,80933,1226837,1307770
Mississippi,M07,2004,6.7,88820,1239896,1328716
Mississippi,M06,2004,6.8,90523,1235601,1326124
Mississippi,M05,2004,5.9,77966,1234657,1312623
Mississippi,M04,2004,5.1,66775,1236302,1303077
Mississippi,M03,2004,5.5,71878,1232380,1304258
Mississippi,M02,2004,5.6,73532,1230142,1303674
Mississippi,M01,2004,6.3,82074,1221203,1303277
Mississippi,M12,2003,5.6,73578,1243095,1316673
Mississippi,M11,2003,5.4,70318,1241139,1311457
Mississippi,M10,2003,5.9,77610,1234139,1311749
Mississippi,M09,2003,5.7,74323,1222891,1297214
Mississippi,M08,2003,6.0,77514,1216814,1294328
Mississippi,M07,2003,6.8,89769,1225185,1314954
Mississippi,M06,2003,7.6,99573,1218679,1318252
Mississippi,M05,2003,6.6,85289,1212623,1297912
Mississippi,M04,2003,6.0,77116,1212146,1289262
Mississippi,M03,2003,6.4,82295,1206560,1288855
Mississippi,M02,2003,6.6,84547,1203529,1288076
Mississippi,M01,2003,7.3,93324,1192940,1286264
Mississippi,M12,2002,6.6,85644,1211771,1297415
Mississippi,M11,2002,6.3,80624,1204831,1285455
Mississippi,M10,2002,6.5,83603,1205286,1288889
Mississippi,M09,2002,6.0,76766,1205050,1281816
Mississippi,M08,2002,6.2,79481,1197688,1277169
Mississippi,M07,2002,6.8,87516,1206726,1294242
Mississippi,M06,2002,7.2,92850,1204524,1297374
Mississippi,M05,2002,6.5,83042,1201100,1284142
Mississippi,M04,2002,6.3,81033,1198366,1279399
Mississippi,M03,2002,6.8,87147,1197581,1284728
Mississippi,M02,2002,6.9,88409,1197872,1286281
Mississippi,M01,2002,7.4,94427,1183492,1277919
Mississippi,M12,2001,6.5,84539,1210355,1294894
Mississippi,M11,2001,6.1,78454,1207333,1285787
Mississippi,M10,2001,6.1,78087,1208123,1286210
Mississippi,M09,2001,5.4,69517,1210085,1279602
Mississippi,M08,2001,5.5,70378,1207734,1278112
Mississippi,M07,2001,5.5,71493,1229387,1300880
Mississippi,M06,2001,5.8,74951,1228111,1303062
Mississippi,M05,2001,4.9,63542,1230494,1294036
Mississippi,M04,2001,4.6,59823,1233573,1293396
Mississippi,M03,2001,5.4,70642,1237170,1307812
Mississippi,M02,2001,5.1,66560,1236145,1302705
Mississippi,M01,2001,5.5,71620,1231489,1303109
Mississippi,M12,2000,4.7,62585,1255050,1317635
Mississippi,M11,2000,4.8,63188,1248911,1312099
Mississippi,M10,2000,5.0,65369,1245509,1310878
Mississippi,M09,2000,4.8,63166,1241048,1304214
Mississippi,M08,2000,5.3,69410,1243282,1312692
Mississippi,M07,2000,5.7,76014,1255947,1331961
Mississippi,M06,2000,6.1,81949,1258924,1340873
Mississippi,M05,2000,5.6,74563,1252507,1327070
Mississippi,M04,2000,4.9,65236,1255008,1320244
Mississippi,M03,2000,5.7,74890,1248158,1323048
Mississippi,M02,2000,5.8,76362,1242767,1319129
Mississippi,M01,2000,6.1,79575,1231773,1311348
Connecticut,M12,2016,3.9,73548,1802260,1875808
Connecticut,M11,2016,3.9,73411,1808747,1882158
Connecticut,M10,2016,4.2,79435,1806297,1885732
Connecticut,M09,2016,4.6,86819,1797101,1883920
Connecticut,M08,2016,5.2,98951,1808079,1907030
Connecticut,M07,2016,5.4,103538,1821231,1924769
Connecticut,M06,2016,5.4,103749,1809327,1913076
Connecticut,M05,2016,5.1,97111,1798458,1895569
Connecticut,M04,2016,5.3,99967,1781929,1881896
Connecticut,M03,2016,5.9,110688,1779853,1890541
Connecticut,M02,2016,6.0,113325,1767439,1880764
Connecticut,M01,2016,6.1,114735,1765510,1880245
Connecticut,M12,2015,5.2,97111,1784527,1881638
Connecticut,M11,2015,5.1,96814,1789143,1885957
Connecticut,M10,2015,5.2,97683,1789384,1887067
Connecticut,M09,2015,5.3,99599,1779274,1878873
Connecticut,M08,2015,5.7,108988,1794655,1903643
Connecticut,M07,2015,5.9,112756,1807218,1919974
Connecticut,M06,2015,5.7,107994,1799729,1907723
Connecticut,M05,2015,5.6,106100,1789337,1895437
Connecticut,M04,2015,5.7,106836,1774585,1881421
Connecticut,M03,2015,6.2,116827,1767084,1883911
Connecticut,M02,2015,6.5,122784,1757026,1879810
Connecticut,M01,2015,6.7,125349,1755267,1880616
Connecticut,M12,2014,5.6,105535,1771605,1877140
Connecticut,M11,2014,5.9,112065,1777867,1889932
Connecticut,M10,2014,6.1,114716,1777706,1892422
Connecticut,M09,2014,6.2,117082,1764839,1881921
Connecticut,M08,2014,6.7,127480,1777647,1905127
Connecticut,M07,2014,6.8,131122,1787640,1918762
Connecticut,M06,2014,6.6,126262,1775060,1901322
Connecticut,M05,2014,6.6,124549,1760108,1884657
Connecticut,M04,2014,6.4,119932,1744042,1863974
Connecticut,M03,2014,7.3,136679,1735242,1871921
Connecticut,M02,2014,7.5,139729,1718888,1858617
Connecticut,M01,2014,7.6,140377,1718681,1859058
Connecticut,M12,2013,6.7,125103,1733915,1859018
Connecticut,M11,2013,6.8,127782,1738116,1865898
Connecticut,M10,2013,7.2,135051,1729288,1864339
Connecticut,M09,2013,7.5,139133,1727061,1866194
Connecticut,M08,2013,8.0,150204,1738802,1889006
Connecticut,M07,2013,8.1,153920,1753990,1907910
Connecticut,M06,2013,8.0,150443,1740429,1890872
Connecticut,M05,2013,7.8,146119,1726673,1872792
Connecticut,M04,2013,7.6,141444,1711054,1852498
Connecticut,M03,2013,8.2,151761,1702479,1854240
Connecticut,M02,2013,8.5,157764,1692016,1849780
Connecticut,M01,2013,8.6,159994,1693322,1853316
Connecticut,M12,2012,7.6,141741,1718588,1860329
Connecticut,M11,2012,7.8,145875,1724834,1870709
Connecticut,M10,2012,8.1,151398,1728752,1880150
Connecticut,M09,2012,8.2,154446,1719376,1873822
Connecticut,M08,2012,8.8,167353,1730910,1898263
Connecticut,M07,2012,8.9,170923,1750093,1921016
Connecticut,M06,2012,8.6,164489,1744918,1909407
Connecticut,M05,2012,8.3,156870,1739160,1896030
Connecticut,M04,2012,8.0,151296,1728433,1879729
Connecticut,M03,2012,8.5,160375,1729058,1889433
Connecticut,M02,2012,8.6,162857,1721827,1884684
Connecticut,M01,2012,8.7,163347,1722105,1885452
Connecticut,M12,2011,7.7,146465,1747213,1893678
Connecticut,M11,2011,8.0,151964,1753900,1905864
Connecticut,M10,2011,8.2,156465,1753975,1910440
Connecticut,M09,2011,8.4,161089,1746732,1907821
Connecticut,M08,2011,8.9,171750,1758503,1930253
Connecticut,M07,2011,9.1,177170,1768357,1945527
Connecticut,M06,2011,9.0,174621,1759499,1934120
Connecticut,M05,2011,8.9,170615,1751887,1922502
Connecticut,M04,2011,8.8,167551,1739359,1906910
Connecticut,M03,2011,9.3,178272,1731483,1909755
Connecticut,M02,2011,9.6,183533,1720552,1904085
Connecticut,M01,2011,9.8,186198,1720138,1906336
Connecticut,M12,2010,8.7,166091,1740348,1906439
Connecticut,M11,2010,9.0,171805,1746666,1918471
Connecticut,M10,2010,8.9,171390,1749577,1920967
Connecticut,M09,2010,9.0,172477,1743555,1916032
Connecticut,M08,2010,9.3,181227,1758396,1939623
Connecticut,M07,2010,9.3,182201,1767051,1949252
Connecticut,M06,2010,9.1,175187,1755839,1931026
Connecticut,M05,2010,8.9,170377,1744023,1914400
Connecticut,M04,2010,8.9,168356,1729553,1897909
Connecticut,M03,2010,9.2,174380,1711698,1886078
Connecticut,M02,2010,9.5,178344,1701452,1879796
Connecticut,M01,2010,9.5,179315,1701235,1880550
Connecticut,M12,2009,8.3,156142,1725098,1881240
Connecticut,M11,2009,8.3,157770,1738780,1896550
Connecticut,M10,2009,8.3,157579,1737958,1895537
Connecticut,M09,2009,8.3,156116,1733046,1889162
Connecticut,M08,2009,8.4,160839,1754019,1914858
Connecticut,M07,2009,8.3,160155,1768285,1928440
Connecticut,M06,2009,8.0,152472,1757701,1910173
Connecticut,M05,2009,7.6,143787,1745834,1889621
Connecticut,M04,2009,7.4,138130,1735776,1873906
Connecticut,M03,2009,7.5,140916,1731453,1872369
Connecticut,M02,2009,7.5,140150,1729498,1869648
Connecticut,M01,2009,7.3,137216,1734204,1871420
Connecticut,M12,2008,6.1,114489,1762996,1877485
Connecticut,M11,2008,6.1,115891,1774498,1890389
Connecticut,M10,2008,6.0,113488,1779479,1892967
Connecticut,M09,2008,6.0,112297,1770180,1882477
Connecticut,M08,2008,6.2,117252,1786324,1903576
Connecticut,M07,2008,6.0,115125,1800970,1916095
Connecticut,M06,2008,5.6,106224,1792702,1898926
Connecticut,M05,2008,5.3,98694,1780184,1878878
Connecticut,M04,2008,4.8,88567,1770608,1859175
Connecticut,M03,2008,5.3,98409,1763818,1862227
Connecticut,M02,2008,5.4,100217,1755349,1855566
Connecticut,M01,2008,5.4,100621,1759063,1859684
Connecticut,M12,2007,4.4,81831,1778862,1860693
Connecticut,M11,2007,4.5,84960,1787491,1872451
Connecticut,M10,2007,4.4,81770,1784362,1866132
Connecticut,M09,2007,4.4,81627,1774758,1856385
Connecticut,M08,2007,4.6,86160,1787142,1873302
Connecticut,M07,2007,4.8,89866,1800743,1890609
Connecticut,M06,2007,4.5,83752,1788878,1872630
Connecticut,M05,2007,4.2,77802,1772718,1850520
Connecticut,M04,2007,4.0,73918,1758802,1832720
Connecticut,M03,2007,4.4,80143,1756063,1836206
Connecticut,M02,2007,4.7,86083,1743701,1829784
Connecticut,M01,2007,4.8,88686,1744391,1833077
Connecticut,M12,2006,3.7,68354,1769225,1837579
Connecticut,M11,2006,4.0,74356,1769038,1843394
Connecticut,M10,2006,3.9,72332,1767443,1839775
Connecticut,M09,2006,4.2,77363,1750345,1827708
Connecticut,M08,2006,4.6,84352,1767185,1851537
Connecticut,M07,2006,4.7,87974,1774895,1862869
Connecticut,M06,2006,4.4,81485,1762801,1844286
Connecticut,M05,2006,4.2,76384,1746796,1823180
Connecticut,M04,2006,4.0,73125,1732930,1806055
Connecticut,M03,2006,4.5,81371,1725450,1806821
Connecticut,M02,2006,4.8,87311,1713554,1800865
Connecticut,M01,2006,5.0,89114,1710635,1799749
Connecticut,M12,2005,4.0,71883,1727852,1799735
Connecticut,M11,2005,4.5,80726,1728149,1808875
Connecticut,M10,2005,4.4,79714,1728837,1808551
Connecticut,M09,2005,4.7,84156,1712892,1797048
Connecticut,M08,2005,5.0,90102,1729623,1819725
Connecticut,M07,2005,5.2,95731,1736689,1832420
Connecticut,M06,2005,5.1,92986,1722778,1815764
Connecticut,M05,2005,5.0,89549,1707109,1796658
Connecticut,M04,2005,4.8,85574,1693532,1779106
Connecticut,M03,2005,5.1,91032,1682854,1773886
Connecticut,M02,2005,5.4,95053,1671840,1766893
Connecticut,M01,2005,5.4,94626,1670427,1765053
Connecticut,M12,2004,4.2,74028,1693366,1767394
Connecticut,M11,2004,4.5,79774,1697610,1777384
Connecticut,M10,2004,4.4,78147,1696050,1774197
Connecticut,M09,2004,4.6,80344,1683026,1763370
Connecticut,M08,2004,4.9,88456,1702557,1791013
Connecticut,M07,2004,5.2,94607,1713266,1807873
Connecticut,M06,2004,5.2,92739,1699222,1791961
Connecticut,M05,2004,5.0,88874,1684526,1773400
Connecticut,M04,2004,4.9,85939,1673184,1759123
Connecticut,M03,2004,5.4,94842,1667287,1762129
Connecticut,M02,2004,5.6,97930,1661246,1759176
Connecticut,M01,2004,5.7,100082,1663217,1763299
Connecticut,M12,2003,4.6,81653,1685448,1767101
Connecticut,M11,2003,5.1,90639,1691849,1782488
Connecticut,M10,2003,5.0,89132,1693055,1782187
Connecticut,M09,2003,5.2,91743,1679262,1771005
Connecticut,M08,2003,5.5,99085,1699212,1798297
Connecticut,M07,2003,5.7,104296,1711099,1815395
Connecticut,M06,2003,5.7,103629,1703302,1806931
Connecticut,M05,2003,5.4,96334,1689615,1785949
Connecticut,M04,2003,5.3,93675,1681240,1774915
Connecticut,M03,2003,5.6,99907,1677380,1777287
Connecticut,M02,2003,5.8,102928,1671405,1774333
Connecticut,M01,2003,5.8,103012,1672226,1775238
Connecticut,M12,2002,4.7,84346,1692721,1777067
Connecticut,M11,2002,4.9,87000,1697858,1784858
Connecticut,M10,2002,4.6,81363,1704890,1786253
Connecticut,M09,2002,4.5,80331,1697672,1778003
Connecticut,M08,2002,4.7,83675,1714199,1797874
Connecticut,M07,2002,4.7,85361,1723212,1808573
Connecticut,M06,2002,4.4,79789,1713517,1793306
Connecticut,M05,2002,4.1,72366,1699880,1772246
Connecticut,M04,2002,3.8,66444,1687366,1753810
Connecticut,M03,2002,3.8,66839,1683710,1750549
Connecticut,M02,2002,3.9,68616,1677738,1746354
Connecticut,M01,2002,3.9,68170,1672765,1740935
Connecticut,M12,2001,2.8,48312,1700454,1748766
Connecticut,M11,2001,2.9,50723,1704136,1754859
Connecticut,M10,2001,2.8,48837,1708523,1757360
Connecticut,M09,2001,3.0,51809,1698903,1750712
Connecticut,M08,2001,3.4,60055,1713905,1773960
Connecticut,M07,2001,3.5,63406,1732127,1795533
Connecticut,M06,2001,3.4,60999,1718435,1779434
Connecticut,M05,2001,3.1,54102,1705596,1759698
Connecticut,M04,2001,2.9,51363,1696234,1747597
Connecticut,M03,2001,3.2,56536,1696120,1752656
Connecticut,M02,2001,3.3,57486,1688675,1746161
Connecticut,M01,2001,3.3,57035,1694174,1751209
Connecticut,M12,2000,1.8,32014,1721302,1753316
Connecticut,M11,2000,1.9,32516,1723446,1755962
Connecticut,M10,2000,1.7,29034,1727889,1756923
Connecticut,M09,2000,1.8,32117,1717968,1750085
Connecticut,M08,2000,2.3,41626,1738942,1780568
Connecticut,M07,2000,2.6,47007,1749764,1796771
Connecticut,M06,2000,2.5,44622,1740881,1785503
Connecticut,M05,2000,2.4,41792,1721846,1763638
Connecticut,M04,2000,2.3,40795,1715683,1756478
Connecticut,M03,2000,2.9,50257,1709331,1759588
Connecticut,M02,2000,3.2,56950,1698859,1755809
Connecticut,M01,2000,3.3,57825,1697042,1754867
New Mexico,M12,2016,6.3,58415,876181,934596
New Mexico,M11,2016,6.5,60388,874658,935046
New Mexico,M10,2016,6.6,61112,868235,929347
New Mexico,M09,2016,6.8,62481,862890,925371
New Mexico,M08,2016,7.1,66051,862166,928217
New Mexico,M07,2016,7.5,69792,862396,932188
New Mexico,M06,2016,7.5,70024,862330,932354
New Mexico,M05,2016,6.4,58612,861046,919658
New Mexico,M04,2016,6.2,57581,864140,921721
New Mexico,M03,2016,6.6,60404,861694,922098
New Mexico,M02,2016,6.7,62267,864232,926499
New Mexico,M01,2016,6.8,62184,858978,921162
New Mexico,M12,2015,6.2,57862,868800,926662
New Mexico,M11,2015,6.4,59038,869311,928349
New Mexico,M10,2015,6.3,58646,867757,926403
New Mexico,M09,2015,6.4,58628,859965,918593
New Mexico,M08,2015,6.7,61690,861281,922971
New Mexico,M07,2015,7.2,66661,861453,928114
New Mexico,M06,2015,7.3,67924,863202,931126
New Mexico,M05,2015,6.4,58433,861647,920080
New Mexico,M04,2015,6.1,56406,864809,921215
New Mexico,M03,2015,6.5,59712,860403,920115
New Mexico,M02,2015,6.7,61843,862216,924059
New Mexico,M01,2015,6.6,61236,860453,921689
New Mexico,M12,2014,6.0,55533,872457,927990
New Mexico,M11,2014,6.3,58267,872024,930291
New Mexico,M10,2014,6.2,57970,870381,928351
New Mexico,M09,2014,6.5,60070,859600,919670
New Mexico,M08,2014,6.9,63526,858741,922267
New Mexico,M07,2014,7.4,68710,858927,927637
New Mexico,M06,2014,7.5,69377,856914,926291
New Mexico,M05,2014,6.5,59817,856767,916584
New Mexico,M04,2014,6.3,57807,857120,914927
New Mexico,M03,2014,6.8,62458,853307,915765
New Mexico,M02,2014,7.1,65132,854673,919805
New Mexico,M01,2014,7.1,65239,853839,919078
New Mexico,M12,2013,6.6,61285,864541,925826
New Mexico,M11,2013,6.8,62740,864121,926861
New Mexico,M10,2013,6.9,63324,860539,923863
New Mexico,M09,2013,6.9,63083,856447,919530
New Mexico,M08,2013,7.1,65451,855955,921406
New Mexico,M07,2013,7.5,69765,856587,926352
New Mexico,M06,2013,7.7,71408,857361,928769
New Mexico,M05,2013,6.5,60185,859473,919658
New Mexico,M04,2013,6.4,58703,862056,920759
New Mexico,M03,2013,6.7,61201,856757,917958
New Mexico,M02,2013,7.2,66366,860019,926385
New Mexico,M01,2013,7.3,67816,857669,925485
New Mexico,M12,2012,6.8,63206,871330,934536
New Mexico,M11,2012,6.8,63408,873375,936783
New Mexico,M10,2012,6.8,63267,872945,936212
New Mexico,M09,2012,6.8,63150,860937,924087
New Mexico,M08,2012,7.3,67298,857203,924501
New Mexico,M07,2012,7.7,72032,859448,931480
New Mexico,M06,2012,7.8,73175,861772,934947
New Mexico,M05,2012,6.7,61825,857089,918914
New Mexico,M04,2012,6.6,60275,859239,919514
New Mexico,M03,2012,7.1,65876,857446,923322
New Mexico,M02,2012,7.5,69306,856846,926152
New Mexico,M01,2012,7.7,71312,851769,923081
New Mexico,M12,2011,7.2,67342,867005,934347
New Mexico,M11,2011,7.3,68229,866625,934854
New Mexico,M10,2011,7.4,68797,864222,933019
New Mexico,M09,2011,7.6,70424,860188,930612
New Mexico,M08,2011,7.8,72609,859171,931780
New Mexico,M07,2011,8.0,74832,861394,936226
New Mexico,M06,2011,8.1,76016,861527,937543
New Mexico,M05,2011,7.1,65710,858240,923950
New Mexico,M04,2011,7.0,64712,860532,925244
New Mexico,M03,2011,7.3,67853,856187,924040
New Mexico,M02,2011,7.6,70517,856367,926884
New Mexico,M01,2011,7.9,73576,852207,925783
New Mexico,M12,2010,7.3,68499,865091,933590
New Mexico,M11,2010,7.6,71582,865265,936847
New Mexico,M10,2010,7.7,72305,864341,936646
New Mexico,M09,2010,8.0,74453,858213,932666
New Mexico,M08,2010,8.4,78984,860706,939690
New Mexico,M07,2010,8.8,83399,864904,948303
New Mexico,M06,2010,9.0,85751,863872,949623
New Mexico,M05,2010,8.1,75441,859923,935364
New Mexico,M04,2010,7.9,74198,861407,935605
New Mexico,M03,2010,8.2,75949,853710,929659
New Mexico,M02,2010,8.1,75482,854176,929658
New Mexico,M01,2010,8.1,75159,850237,925396
New Mexico,M12,2009,7.4,69032,864633,933665
New Mexico,M11,2009,7.5,70284,867681,937965
New Mexico,M10,2009,7.5,69982,867072,937054
New Mexico,M09,2009,7.6,71249,863819,935068
New Mexico,M08,2009,8.0,75217,866662,941879
New Mexico,M07,2009,8.4,80064,870150,950214
New Mexico,M06,2009,8.7,82628,869307,951935
New Mexico,M05,2009,7.6,71167,867584,938751
New Mexico,M04,2009,7.2,67987,871732,939719
New Mexico,M03,2009,7.3,68467,869901,938368
New Mexico,M02,2009,6.7,63475,877150,940625
New Mexico,M01,2009,6.5,60778,878197,938975
New Mexico,M12,2008,5.2,48927,900148,949075
New Mexico,M11,2008,4.9,46643,906080,952723
New Mexico,M10,2008,4.6,44325,909196,953521
New Mexico,M09,2008,4.6,43749,904094,947843
New Mexico,M08,2008,4.7,44296,903176,947472
New Mexico,M07,2008,4.9,46627,906398,953025
New Mexico,M06,2008,4.9,46969,904828,951797
New Mexico,M05,2008,3.9,36834,900507,937341
New Mexico,M04,2008,3.7,34759,902382,937141
New Mexico,M03,2008,4.0,37880,897854,935734
New Mexico,M02,2008,3.9,36695,899121,935816
New Mexico,M01,2008,4.1,37938,895148,933086
New Mexico,M12,2007,3.5,33068,910391,943459
New Mexico,M11,2007,3.5,33036,911273,944309
New Mexico,M10,2007,3.5,32465,907358,939823
New Mexico,M09,2007,3.6,33268,900043,933311
New Mexico,M08,2007,3.7,34845,898700,933545
New Mexico,M07,2007,4.2,39920,901749,941669
New Mexico,M06,2007,4.4,41725,899572,941297
New Mexico,M05,2007,3.6,32946,893564,926510
New Mexico,M04,2007,3.5,32312,893697,926009
New Mexico,M03,2007,3.7,34579,892997,927576
New Mexico,M02,2007,3.8,34996,891851,926847
New Mexico,M01,2007,4.0,37184,886780,923964
New Mexico,M12,2006,3.4,32123,903079,935202
New Mexico,M11,2006,3.7,34822,901895,936717
New Mexico,M10,2006,3.8,35694,898922,934616
New Mexico,M09,2006,4.1,38043,891848,929891
New Mexico,M08,2006,4.4,40925,890015,930940
New Mexico,M07,2006,4.8,44513,891960,936473
New Mexico,M06,2006,5.0,46950,891453,938403
New Mexico,M05,2006,4.1,37499,884851,922350
New Mexico,M04,2006,3.9,35757,884175,919932
New Mexico,M03,2006,4.1,37993,880531,918524
New Mexico,M02,2006,4.3,39131,880446,919577
New Mexico,M01,2006,4.4,40306,874195,914501
New Mexico,M12,2005,4.2,38487,887365,925852
New Mexico,M11,2005,4.5,41356,886434,927790
New Mexico,M10,2005,4.6,42278,883280,925558
New Mexico,M09,2005,4.8,44405,875010,919415
New Mexico,M08,2005,5.1,46864,874262,921126
New Mexico,M07,2005,5.6,51726,875118,926844
New Mexico,M06,2005,5.9,54670,870621,925291
New Mexico,M05,2005,5.0,45753,865898,911651
New Mexico,M04,2005,5.0,45979,866272,912251
New Mexico,M03,2005,5.5,49629,858147,907776
New Mexico,M02,2005,5.5,50253,858499,908752
New Mexico,M01,2005,5.7,51496,854064,905560
New Mexico,M12,2004,5.0,45505,868824,914329
New Mexico,M11,2004,5.0,46059,868226,914285
New Mexico,M10,2004,5.0,45814,864654,910468
New Mexico,M09,2004,5.2,46912,853348,900260
New Mexico,M08,2004,5.5,49523,853458,902981
New Mexico,M07,2004,5.9,53247,855967,909214
New Mexico,M06,2004,6.2,56188,851652,907840
New Mexico,M05,2004,5.3,47261,846804,894065
New Mexico,M04,2004,5.3,47779,847318,895097
New Mexico,M03,2004,5.8,51776,841691,893467
New Mexico,M02,2004,5.7,51347,842547,893894
New Mexico,M01,2004,6.1,54424,836859,891283
New Mexico,M12,2003,5.4,48751,850980,899731
New Mexico,M11,2003,5.6,50791,850106,900897
New Mexico,M10,2003,5.6,50493,847169,897662
New Mexico,M09,2003,5.8,51407,838121,889528
New Mexico,M08,2003,6.0,53271,838839,892110
New Mexico,M07,2003,6.5,58113,840702,898815
New Mexico,M06,2003,6.7,59847,837854,897701
New Mexico,M05,2003,5.6,49224,832301,881525
New Mexico,M04,2003,5.5,48483,833061,881544
New Mexico,M03,2003,5.8,50597,828149,878746
New Mexico,M02,2003,5.8,50754,829588,880342
New Mexico,M01,2003,6.0,53029,825136,878165
New Mexico,M12,2002,5.2,46136,838718,884854
New Mexico,M11,2002,5.3,47021,837479,884500
New Mexico,M10,2002,5.2,45788,835443,881231
New Mexico,M09,2002,5.3,46149,830079,876228
New Mexico,M08,2002,5.6,48805,828719,877524
New Mexico,M07,2002,6.1,53817,830057,883874
New Mexico,M06,2002,6.4,56225,826714,882939
New Mexico,M05,2002,5.4,46941,821612,868553
New Mexico,M04,2002,5.3,45983,820742,866725
New Mexico,M03,2002,5.5,47829,816191,864020
New Mexico,M02,2002,5.6,48070,816675,864745
New Mexico,M01,2002,5.6,48156,810597,858753
New Mexico,M12,2001,4.8,41254,824601,865855
New Mexico,M11,2001,4.8,41826,823499,865325
New Mexico,M10,2001,4.7,40357,821979,862336
New Mexico,M09,2001,4.7,40071,816304,856375
New Mexico,M08,2001,4.7,40648,816031,856679
New Mexico,M07,2001,5.3,45430,819645,865075
New Mexico,M06,2001,5.5,47879,817523,865402
New Mexico,M05,2001,4.6,39443,812808,852251
New Mexico,M04,2001,4.6,39600,812886,852486
New Mexico,M03,2001,5.0,42598,809284,851882
New Mexico,M02,2001,5.1,43656,809192,852848
New Mexico,M01,2001,5.3,44926,803953,848879
New Mexico,M12,2000,4.4,37736,818657,856393
New Mexico,M11,2000,4.6,39540,817166,856706
New Mexico,M10,2000,4.6,39084,813785,852869
New Mexico,M09,2000,4.6,39233,807050,846283
New Mexico,M08,2000,4.9,41667,806417,848084
New Mexico,M07,2000,5.2,44514,807675,852189
New Mexico,M06,2000,5.6,47446,803968,851414
New Mexico,M05,2000,4.8,40130,798456,838586
New Mexico,M04,2000,4.7,39033,799879,838912
New Mexico,M03,2000,5.1,42481,794271,836752
New Mexico,M02,2000,5.2,43741,793627,837368
New Mexico,M01,2000,5.4,45220,788288,833508
California,M12,2016,5.0,957110,18141342,19098452
California,M11,2016,5.0,963869,18193752,19157621
California,M10,2016,5.2,1007701,18193795,19201496
California,M09,2016,5.2,1004338,18181708,19186046
California,M08,2016,5.6,1069094,18109246,19178340
California,M07,2016,5.8,1115050,18094177,19209227
California,M06,2016,5.6,1060958,18046023,19106981
California,M05,2016,4.9,941445,18080448,19021893
California,M04,2016,5.4,1019131,18010899,19030030
California,M03,2016,5.8,1104679,17980341,19085020
California,M02,2016,5.8,1096284,17945007,19041291
California,M01,2016,5.9,1112542,17803776,18916318
California,M12,2015,5.6,1053227,17842631,18895858
California,M11,2015,5.7,1071735,17837680,18909415
California,M10,2015,5.7,1070733,17841943,18912676
California,M09,2015,5.6,1045795,17784349,18830144
California,M08,2015,6.1,1144460,17762355,18906815
California,M07,2015,6.5,1235142,17738251,18973393
California,M06,2015,6.3,1185354,17737117,18922471
California,M05,2015,6.1,1154906,17784721,18939627
California,M04,2015,6.2,1161275,17691245,18852520
California,M03,2015,6.7,1258970,17599231,18858201
California,M02,2015,6.9,1297625,17576106,18873731
California,M01,2015,7.2,1359407,17483563,18842970
California,M12,2014,6.6,1246940,17521352,18768292
California,M11,2014,7.0,1313238,17556197,18869435
California,M10,2014,6.9,1306774,17582732,18889506
California,M09,2014,7.0,1310322,17486929,18797251
California,M08,2014,7.6,1429944,17385351,18815295
California,M07,2014,7.9,1492642,17356989,18849631
California,M06,2014,7.4,1393023,17351792,18744815
California,M05,2014,7.2,1342390,17346964,18689354
California,M04,2014,7.3,1353441,17259929,18613370
California,M03,2014,8.3,1552238,17194358,18746596
California,M02,2014,8.4,1564923,17122102,18687025
California,M01,2014,8.4,1570680,17019049,18589729
California,M12,2013,8.0,1485483,17057695,18543178
California,M11,2013,8.3,1541085,17077760,18618845
California,M10,2013,8.5,1589404,17010656,18600060
California,M09,2013,8.5,1579781,17088933,18668714
California,M08,2013,8.9,1668158,17021554,18689712
California,M07,2013,9.3,1751371,16999909,18751280
California,M06,2013,9.2,1722623,16980661,18703284
California,M05,2013,8.6,1595134,17016340,18611474
California,M04,2013,8.7,1616169,16925324,18541493
California,M03,2013,9.3,1731830,16820663,18552493
California,M02,2013,9.7,1802452,16802060,18604512
California,M01,2013,10.2,1903584,16703259,18606843
California,M12,2012,9.6,1782183,16797526,18579709
California,M11,2012,9.5,1758087,16815181,18573268
California,M10,2012,9.7,1802219,16848344,18650563
California,M09,2012,9.6,1784926,16783154,18568080
California,M08,2012,10.4,1933475,16621559,18555034
California,M07,2012,10.9,2034354,16583630,18617984
California,M06,2012,10.6,1976656,16587936,18564592
California,M05,2012,10.2,1878836,16597694,18476530
California,M04,2012,10.3,1894553,16493709,18388262
California,M03,2012,11.0,2034002,16434011,18468013
California,M02,2012,11.3,2079241,16388435,18467676
California,M01,2012,11.4,2094925,16280881,18375806
California,M12,2011,11.0,2037162,16432126,18469288
California,M11,2011,11.0,2040713,16444996,18485709
California,M10,2011,11.3,2092602,16425710,18518312
California,M09,2011,11.5,2123813,16387273,18511086
California,M08,2011,11.9,2196059,16301498,18497557
California,M07,2011,12.2,2252178,16212774,18464952
California,M06,2011,12.0,2199374,16201173,18400547
California,M05,2011,11.3,2071724,16260988,18332712
California,M04,2011,11.5,2108789,16204892,18313681
California,M03,2011,12.1,2215482,16138231,18353713
California,M02,2011,12.2,2243773,16082636,18326409
California,M01,2011,12.6,2301932,16005295,18307227
California,M12,2010,12.1,2212970,16116806,18329776
California,M11,2010,12.3,2268418,16118593,18387011
California,M10,2010,11.9,2188602,16160340,18348942
California,M09,2010,11.9,2197318,16196643,18393961
California,M08,2010,12.3,2271603,16171990,18443593
California,M07,2010,12.6,2316525,16115939,18432464
California,M06,2010,12.0,2206906,16123264,18330170
California,M05,2010,11.7,2140341,16178497,18318838
California,M04,2010,12.0,2201236,16156408,18357644
California,M03,2010,12.6,2312390,15970655,18283045
California,M02,2010,12.6,2300364,15931087,18231451
California,M01,2010,12.7,2315237,15863115,18178352
California,M12,2009,11.8,2134358,15940443,18074801
California,M11,2009,11.7,2127225,16047439,18174664
California,M10,2009,11.6,2114293,16049503,18163796
California,M09,2009,11.4,2079035,16080505,18159540
California,M08,2009,11.5,2105749,16149025,18254774
California,M07,2009,11.7,2142067,16185170,18327237
California,M06,2009,11.3,2060228,16206959,18267187
California,M05,2009,10.6,1931991,16260585,18192576
California,M04,2009,10.4,1900577,16300947,18201524
California,M03,2009,10.9,1991432,16257780,18249212
California,M02,2009,10.6,1935243,16339886,18275129
California,M01,2009,10.2,1868614,16372621,18241235
California,M12,2008,9.0,1642244,16629680,18271924
California,M11,2008,8.4,1541436,16748815,18290251
California,M10,2008,8.0,1461880,16863303,18325183
California,M09,2008,7.7,1397892,16873297,18271189
California,M08,2008,7.8,1419146,16873372,18292518
California,M07,2008,7.6,1397333,16908797,18306130
California,M06,2008,7.0,1273683,16922825,18196508
California,M05,2008,6.4,1163777,16932233,18096010
California,M04,2008,6.1,1103750,16936957,18040707
California,M03,2008,6.6,1185778,16865764,18051542
California,M02,2008,6.3,1138022,16854691,17992713
California,M01,2008,6.4,1158755,16844050,18002805
California,M12,2007,5.9,1056279,16957504,18013783
California,M11,2007,5.6,1011518,17020073,18031591
California,M10,2007,5.4,968525,16993192,17961717
California,M09,2007,5.3,958487,17003870,17962357
California,M08,2007,5.4,971032,16958142,17929174
California,M07,2007,5.7,1023914,16981299,18005213
California,M06,2007,5.3,940705,16958054,17898759
California,M05,2007,4.8,846097,16922244,17768341
California,M04,2007,5.0,895083,16863748,17758831
California,M03,2007,5.2,932960,16884325,17817285
California,M02,2007,5.4,956853,16839213,17796066
California,M01,2007,5.5,976429,16797415,17773844
California,M12,2006,4.7,835543,16973698,17809241
California,M11,2006,4.8,850156,16945533,17795689
California,M10,2006,4.5,790341,16962339,17752680
California,M09,2006,4.6,814937,16876453,17691390
California,M08,2006,4.9,871011,16864833,17735844
California,M07,2006,5.2,929434,16812330,17741764
California,M06,2006,4.9,859354,16787870,17647224
California,M05,2006,4.5,798279,16748686,17546965
California,M04,2006,4.9,851019,16686169,17537188
California,M03,2006,5.2,908219,16643163,17551382
California,M02,2006,5.3,936533,16616413,17552946
California,M01,2006,5.3,931417,16555574,17486991
California,M12,2005,4.9,866141,16684971,17551112
California,M11,2005,5.3,934144,16681350,17615494
California,M10,2005,5.0,885728,16744240,17629968
California,M09,2005,5.1,897067,16701783,17598850
California,M08,2005,5.1,901053,16722085,17623138
California,M07,2005,5.5,974062,16662897,17636959
California,M06,2005,5.4,940007,16592894,17532901
California,M05,2005,5.0,878044,16583947,17461991
California,M04,2005,5.3,933072,16520108,17453180
California,M03,2005,5.9,1022813,16404850,17427663
California,M02,2005,6.1,1067481,16378380,17445861
California,M01,2005,6.2,1069341,16314303,17383644
California,M12,2004,5.7,988415,16449459,17437874
California,M11,2004,5.9,1025909,16460854,17486763
California,M10,2004,5.7,996727,16455724,17452451
California,M09,2004,5.6,980739,16388117,17368856
California,M08,2004,5.9,1036235,16400705,17436940
California,M07,2004,6.4,1126663,16365070,17491733
California,M06,2004,6.4,1110874,16279135,17390009
California,M05,2004,5.9,1022495,16247363,17269858
California,M04,2004,6.3,1082702,16197061,17279763
California,M03,2004,7.0,1210036,16142848,17352884
California,M02,2004,6.7,1158806,16162682,17321488
California,M01,2004,7.0,1216022,16098932,17314954
California,M12,2003,6.2,1077323,16195161,17272484
California,M11,2003,6.7,1154660,16182020,17336680
California,M10,2003,6.5,1125283,16187108,17312391
California,M09,2003,6.5,1123298,16108756,17232054
California,M08,2003,6.8,1177265,16110724,17287989
California,M07,2003,7.1,1233181,16069631,17302812
California,M06,2003,7.2,1242949,16100550,17343499
California,M05,2003,6.4,1101497,16091934,17193431
California,M04,2003,6.7,1153757,16088544,17242301
California,M03,2003,7.1,1220814,16047704,17268518
California,M02,2003,7.1,1225139,16058718,17283857
California,M01,2003,7.3,1262170,15993228,17255398
California,M12,2002,6.7,1150804,16109678,17260482
California,M11,2002,6.8,1171647,16088557,17260204
California,M10,2002,6.4,1108613,16203736,17312349
California,M09,2002,6.3,1087708,16211501,17299209
California,M08,2002,6.7,1151628,16160352,17311980
California,M07,2002,6.9,1194605,16104603,17299208
California,M06,2002,6.7,1159420,16104987,17264407
California,M05,2002,6.2,1058144,16133926,17192070
California,M04,2002,6.6,1136828,16072940,17209768
California,M03,2002,6.9,1193760,16068994,17262754
California,M02,2002,6.8,1166825,16103273,17270098
California,M01,2002,7.0,1200966,15941676,17142642
California,M12,2001,6.1,1056823,16143866,17200689
California,M11,2001,6.2,1063627,16124108,17187735
California,M10,2001,5.8,1003763,16198966,17202729
California,M09,2001,5.5,934020,16198098,17132118
California,M08,2001,5.7,969392,16152246,17121638
California,M07,2001,5.5,946952,16229960,17176912
California,M06,2001,5.2,895164,16208083,17103247
California,M05,2001,4.6,782863,16230877,17013740
California,M04,2001,4.9,843091,16215760,17058851
California,M03,2001,5.3,907688,16255569,17163257
California,M02,2001,5.1,866086,16234695,17100781
California,M01,2001,5.3,899642,16179822,17079464
California,M12,2000,4.4,750933,16286486,17037419
California,M11,2000,4.7,799794,16184324,16984118
California,M10,2000,4.5,766227,16184317,16950544
California,M09,2000,4.6,780879,16107485,16888364
California,M08,2000,5.0,854563,16100302,16954865
California,M07,2000,5.3,893996,16039227,16933223
California,M06,2000,5.0,847653,16043536,16891189
California,M05,2000,4.8,800370,15969433,16769803
California,M04,2000,4.8,805179,15977142,16782321
California,M03,2000,5.4,911503,15894584,16806087
California,M02,2000,5.4,900935,15857868,16758803
California,M01,2000,5.4,903510,15753440,16656950
Virginia,M12,2016,3.8,160026,4077960,4237986
Virginia,M11,2016,3.8,159490,4089578,4249068
Virginia,M10,2016,4.0,170163,4087933,4258096
Virginia,M09,2016,4.2,177096,4074123,4251219
Virginia,M08,2016,4.3,183143,4067682,4250825
Virginia,M07,2016,4.2,180463,4103065,4283528
Virginia,M06,2016,4.2,178517,4080272,4258789
Virginia,M05,2016,3.7,158991,4081824,4240815
Virginia,M04,2016,3.6,152750,4073719,4226469
Virginia,M03,2016,4.0,170973,4066926,4237899
Virginia,M02,2016,4.1,174579,4036468,4211047
Virginia,M01,2016,4.2,175530,4003566,4179096
Virginia,M12,2015,3.9,161126,4011264,4172390
Virginia,M11,2015,3.9,162805,4009711,4172516
Virginia,M10,2015,4.0,168607,4012276,4180883
Virginia,M09,2015,4.1,172971,3996920,4169891
Virginia,M08,2015,4.4,183615,4018261,4201876
Virginia,M07,2015,4.6,194167,4058404,4252571
Virginia,M06,2015,4.7,198515,4050093,4248608
Virginia,M05,2015,4.7,199578,4064219,4263797
Virginia,M04,2015,4.3,180507,4052371,4232878
Virginia,M03,2015,4.8,202018,4021059,4223077
Virginia,M02,2015,5.0,211908,4002547,4214455
Virginia,M01,2015,5.2,218303,3993367,4211670
Virginia,M12,2014,4.6,193603,4002285,4195888
Virginia,M11,2014,4.7,199640,4017212,4216852
Virginia,M10,2014,4.8,203932,4035005,4238937
Virginia,M09,2014,5.1,214918,4011448,4226366
Virginia,M08,2014,5.6,235919,4011391,4247310
Virginia,M07,2014,5.6,238978,4059164,4298142
Virginia,M06,2014,5.4,231922,4055534,4287456
Virginia,M05,2014,5.3,226919,4055682,4282601
Virginia,M04,2014,4.8,204329,4049386,4253715
Virginia,M03,2014,5.6,237894,4034955,4272849
Virginia,M02,2014,5.7,241097,4000535,4241632
Virginia,M01,2014,5.7,238951,3984817,4223768
Virginia,M12,2013,5.1,215576,3990587,4206163
Virginia,M11,2013,5.3,221681,3997197,4218878
Virginia,M10,2013,5.7,239523,3973597,4213120
Virginia,M09,2013,5.6,236948,4000293,4237241
Virginia,M08,2013,5.8,246596,4000521,4247117
Virginia,M07,2013,5.9,254213,4038337,4292550
Virginia,M06,2013,6.1,260295,4020774,4281069
Virginia,M05,2013,5.7,242434,4025079,4267513
Virginia,M04,2013,5.3,222330,4010888,4233218
Virginia,M03,2013,5.7,239948,3979673,4219621
Virginia,M02,2013,6.0,254543,3957140,4211683
Virginia,M01,2013,6.4,269659,3940883,4210542
Virginia,M12,2012,5.6,237710,3971067,4208777
Virginia,M11,2012,5.4,228728,3980577,4209305
Virginia,M10,2012,5.6,238911,3999191,4238102
Virginia,M09,2012,5.8,244312,3976937,4221249
Virginia,M08,2012,6.2,262465,3948241,4210706
Virginia,M07,2012,6.4,274236,3984604,4258840
Virginia,M06,2012,6.4,271774,3984658,4256432
Virginia,M05,2012,6.0,256067,3987872,4243939
Virginia,M04,2012,5.6,237833,3974187,4212020
Virginia,M03,2012,6.2,263134,3961176,4224310
Virginia,M02,2012,6.6,276817,3933582,4210399
Virginia,M01,2012,6.6,278300,3913756,4192056
Virginia,M12,2011,6.2,263058,3947056,4210114
Virginia,M11,2011,6.1,257476,3962033,4219509
Virginia,M10,2011,6.4,271547,3958075,4229622
Virginia,M09,2011,6.7,284607,3945763,4230370
Virginia,M08,2011,6.9,292077,3940104,4232181
Virginia,M07,2011,6.7,285582,3958371,4243953
Virginia,M06,2011,6.9,290037,3938453,4228490
Virginia,M05,2011,6.4,270624,3950454,4221078
Virginia,M04,2011,6.2,258678,3944089,4202767
Virginia,M03,2011,6.6,275304,3920152,4195456
Virginia,M02,2011,6.9,286431,3881481,4167912
Virginia,M01,2011,7.1,294293,3865879,4160172
Virginia,M12,2010,6.7,276334,3878118,4154452
Virginia,M11,2010,6.7,280787,3879387,4160174
Virginia,M10,2010,6.6,275847,3886638,4162485
Virginia,M09,2010,6.8,284462,3889648,4174110
Virginia,M08,2010,7.1,298036,3886464,4184500
Virginia,M07,2010,7.1,299948,3905103,4205051
Virginia,M06,2010,7.2,300365,3885392,4185757
Virginia,M05,2010,7.1,296704,3888950,4185654
Virginia,M04,2010,7.0,290853,3886925,4177778
Virginia,M03,2010,7.7,317005,3808307,4125312
Virginia,M02,2010,7.9,324113,3769308,4093421
Virginia,M01,2010,7.9,322815,3760390,4083205
Virginia,M12,2009,7.2,293388,3765971,4059359
Virginia,M11,2009,6.8,278323,3808774,4087097
Virginia,M10,2009,6.8,279679,3806575,4086254
Virginia,M09,2009,6.9,280237,3808930,4089167
Virginia,M08,2009,6.9,284098,3841882,4125980
Virginia,M07,2009,6.8,284983,3892311,4177294
Virginia,M06,2009,7.0,290063,3873123,4163186
Virginia,M05,2009,6.7,276611,3871882,4148493
Virginia,M04,2009,6.2,256044,3879454,4135498
Virginia,M03,2009,6.6,270341,3850840,4121181
Virginia,M02,2009,6.4,265313,3848785,4114098
Virginia,M01,2009,6.1,248775,3861661,4110436
Virginia,M12,2008,4.9,200335,3920357,4120692
Virginia,M11,2008,4.3,178042,3959901,4137943
Virginia,M10,2008,4.0,167538,3986825,4154363
Virginia,M09,2008,4.0,166003,3973948,4139951
Virginia,M08,2008,4.2,173986,3982260,4156246
Virginia,M07,2008,4.1,170943,4030911,4201854
Virginia,M06,2008,4.0,166028,4008519,4174547
Virginia,M05,2008,3.7,153915,3993732,4147647
Virginia,M04,2008,3.2,131364,3993497,4124861
Virginia,M03,2008,3.6,148300,3955693,4103993
Virginia,M02,2008,3.6,148331,3919197,4067528
Virginia,M01,2008,3.7,151395,3920295,4071690
Virginia,M12,2007,3.3,132786,3923959,4056745
Virginia,M11,2007,3.0,120491,3945263,4065754
Virginia,M10,2007,2.9,119062,3928182,4047244
Virginia,M09,2007,3.0,121759,3920977,4042736
Virginia,M08,2007,3.1,125244,3913851,4039095
Virginia,M07,2007,3.1,126825,3964290,4091115
Virginia,M06,2007,3.1,125924,3938854,4064778
Virginia,M05,2007,2.8,114403,3915364,4029767
Virginia,M04,2007,2.7,107718,3898374,4006092
Virginia,M03,2007,2.9,118197,3899303,4017500
Virginia,M02,2007,3.2,128940,3862192,3991132
Virginia,M01,2007,3.3,131632,3858433,3990065
Virginia,M12,2006,2.8,110712,3894204,4004916
Virginia,M11,2006,2.8,112870,3888836,4001706
Virginia,M10,2006,2.7,110011,3890886,4000897
Virginia,M09,2006,3.1,123372,3861651,3985023
Virginia,M08,2006,3.3,130586,3874372,4004958
Virginia,M07,2006,3.3,132780,3902739,4035519
Virginia,M06,2006,3.3,130684,3881924,4012608
Virginia,M05,2006,3.1,121634,3855992,3977626
Virginia,M04,2006,2.9,115033,3837497,3952530
Virginia,M03,2006,3.2,124824,3821245,3946069
Virginia,M02,2006,3.4,133481,3785749,3919230
Virginia,M01,2006,3.3,130103,3772505,3902608
Virginia,M12,2005,3.1,120671,3788763,3909434
Virginia,M11,2005,3.3,127730,3787626,3915356
Virginia,M10,2005,3.2,126694,3801462,3928156
Virginia,M09,2005,3.5,138979,3779745,3918724
Virginia,M08,2005,3.5,139150,3799120,3938270
Virginia,M07,2005,3.6,144050,3822339,3966389
Virginia,M06,2005,3.8,150857,3783489,3934346
Virginia,M05,2005,3.6,142120,3765687,3907807
Virginia,M04,2005,3.5,135221,3745511,3880732
Virginia,M03,2005,3.8,145108,3701593,3846701
Virginia,M02,2005,4.0,153216,3664863,3818079
Virginia,M01,2005,3.9,149609,3650903,3800512
Virginia,M12,2004,3.5,133600,3674204,3807804
Virginia,M11,2004,3.4,131504,3680609,3812113
Virginia,M10,2004,3.4,128976,3673865,3802841
Virginia,M09,2004,3.5,130789,3647767,3778556
Virginia,M08,2004,3.8,144376,3666926,3811302
Virginia,M07,2004,4.0,152386,3701810,3854196
Virginia,M06,2004,4.2,158779,3663721,3822500
Virginia,M05,2004,3.8,145304,3644322,3789626
Virginia,M04,2004,3.6,136632,3636040,3772672
Virginia,M03,2004,4.2,157612,3616656,3774268
Virginia,M02,2004,4.2,156764,3603522,3760286
Virginia,M01,2004,4.3,163006,3593781,3756787
Virginia,M12,2003,3.6,136053,3610240,3746293
Virginia,M11,2003,3.7,140634,3615050,3755684
Virginia,M10,2003,3.7,137587,3609208,3746795
Virginia,M09,2003,4.0,147551,3581040,3728591
Virginia,M08,2003,4.1,154806,3598438,3753244
Virginia,M07,2003,4.3,164871,3628489,3793360
Virginia,M06,2003,4.5,171880,3620622,3792502
Virginia,M05,2003,4.1,152770,3605894,3758664
Virginia,M04,2003,3.9,147848,3605990,3753838
Virginia,M03,2003,4.3,161341,3588710,3750051
Virginia,M02,2003,4.5,166729,3570147,3736876
Virginia,M01,2003,4.6,171192,3557345,3728537
Virginia,M12,2002,4.0,150003,3568646,3718649
Virginia,M11,2002,4.0,149910,3564251,3714161
Virginia,M10,2002,3.8,142037,3597037,3739074
Virginia,M09,2002,3.9,146542,3598106,3744648
Virginia,M08,2002,4.3,161697,3591466,3753163
Virginia,M07,2002,4.3,162360,3612533,3774893
Virginia,M06,2002,4.4,165001,3590892,3755893
Virginia,M05,2002,4.2,156860,3582268,3739128
Virginia,M04,2002,4.2,154227,3558736,3712963
Virginia,M03,2002,4.4,161425,3548826,3710251
Virginia,M02,2002,4.5,166011,3537138,3703149
Virginia,M01,2002,4.6,166697,3484936,3651633
Virginia,M12,2001,3.9,143140,3522682,3665822
Virginia,M11,2001,3.9,141904,3516922,3658826
Virginia,M10,2001,3.8,137806,3530343,3668149
Virginia,M09,2001,3.6,130766,3530100,3660866
Virginia,M08,2001,3.6,131373,3526587,3657960
Virginia,M07,2001,3.3,121172,3599373,3720545
Virginia,M06,2001,3.2,119989,3576135,3696124
Virginia,M05,2001,2.8,103918,3569945,3673863
Virginia,M04,2001,2.6,96707,3567673,3664380
Virginia,M03,2001,2.8,104948,3578518,3683466
Virginia,M02,2001,2.7,98345,3553238,3651583
Virginia,M01,2001,2.6,95076,3544985,3640061
Virginia,M12,2000,1.8,66614,3573811,3640425
Virginia,M11,2000,1.8,65845,3543642,3609487
Virginia,M10,2000,1.8,65501,3535574,3601075
Virginia,M09,2000,2.1,75826,3505035,3580861
Virginia,M08,2000,2.4,85585,3517539,3603124
Virginia,M07,2000,2.4,86739,3549391,3636130
Virginia,M06,2000,2.4,88922,3543804,3632726
Virginia,M05,2000,2.4,85383,3514389,3599772
Virginia,M04,2000,2.1,74818,3531532,3606350
Virginia,M03,2000,2.6,94113,3509982,3604095
Virginia,M02,2000,2.9,102244,3483990,3586234
Virginia,M01,2000,2.9,103763,3465696,3569459
Vermont,M12,2016,2.8,9760,333991,343751
Vermont,M11,2016,2.9,10072,334311,344383
Vermont,M10,2016,2.5,8720,335790,344510
Vermont,M09,2016,3.2,11186,333480,344666
Vermont,M08,2016,3.1,10916,337795,348711
Vermont,M07,2016,3.4,11996,339349,351345
Vermont,M06,2016,3.4,12015,337860,349875
Vermont,M05,2016,3.0,10313,332237,342550
Vermont,M04,2016,3.4,11567,328905,340472
Vermont,M03,2016,3.6,12458,330886,343344
Vermont,M02,2016,3.6,12454,330281,342735
Vermont,M01,2016,4.0,13564,328795,342359
Vermont,M12,2015,3.0,10341,332360,342701
Vermont,M11,2015,3.2,10911,332808,343719
Vermont,M10,2015,2.8,9681,334292,343973
Vermont,M09,2015,3.5,12182,332046,344228
Vermont,M08,2015,3.4,11935,336216,348151
Vermont,M07,2015,3.7,12950,338063,351013
Vermont,M06,2015,3.7,12942,337793,350735
Vermont,M05,2015,3.3,11450,332605,344055
Vermont,M04,2015,3.7,12823,329362,342185
Vermont,M03,2015,4.0,13851,331323,345174
Vermont,M02,2015,4.1,14022,330733,344755
Vermont,M01,2015,4.4,15222,329862,345084
Vermont,M12,2014,3.5,12071,333164,345235
Vermont,M11,2014,3.6,12524,333705,346229
Vermont,M10,2014,3.2,11145,335432,346577
Vermont,M09,2014,3.9,13535,333298,346833
Vermont,M08,2014,3.8,13225,337890,351115
Vermont,M07,2014,4.0,14186,339238,353424
Vermont,M06,2014,4.0,14207,338560,352767
Vermont,M05,2014,3.7,12816,333306,346122
Vermont,M04,2014,4.2,14337,329921,344258
Vermont,M03,2014,4.4,15342,332443,347785
Vermont,M02,2014,4.4,15351,332146,347497
Vermont,M01,2014,4.7,16418,331315,347733
Vermont,M12,2013,3.8,13386,335368,348754
Vermont,M11,2013,4.0,13893,336102,349995
Vermont,M10,2013,3.6,12613,337459,350072
Vermont,M09,2013,4.3,14955,335407,350362
Vermont,M08,2013,4.2,14771,339503,354274
Vermont,M07,2013,4.5,15920,340360,356280
Vermont,M06,2013,4.6,16199,339757,355956
Vermont,M05,2013,4.2,14690,334610,349300
Vermont,M04,2013,4.7,16198,331848,348046
Vermont,M03,2013,4.9,17195,333772,350967
Vermont,M02,2013,4.9,17320,333028,350348
Vermont,M01,2013,5.3,18478,332240,350718
Vermont,M12,2012,4.4,15337,336498,351835
Vermont,M11,2012,4.4,15694,337108,352802
Vermont,M10,2012,4.1,14489,338776,353265
Vermont,M09,2012,4.8,16946,337183,354129
Vermont,M08,2012,4.8,17058,341235,358293
Vermont,M07,2012,5.0,18209,342505,360714
Vermont,M06,2012,5.1,18457,341515,359972
Vermont,M05,2012,4.8,16880,336117,352997
Vermont,M04,2012,5.2,18406,332478,350884
Vermont,M03,2012,5.5,19369,335145,354514
Vermont,M02,2012,5.5,19515,334859,354374
Vermont,M01,2012,5.8,20513,333984,354497
Vermont,M12,2011,4.8,17222,338279,355501
Vermont,M11,2011,5.0,17897,338602,356499
Vermont,M10,2011,4.8,17120,340240,357360
Vermont,M09,2011,5.2,18542,338483,357025
Vermont,M08,2011,5.0,18130,341851,359981
Vermont,M07,2011,5.3,19158,343175,362333
Vermont,M06,2011,5.3,19108,342533,361641
Vermont,M05,2011,5.3,19040,337243,356283
Vermont,M04,2011,6.0,21355,333639,354994
Vermont,M03,2011,6.2,22333,336305,358638
Vermont,M02,2011,6.2,22219,336099,358318
Vermont,M01,2011,6.6,23611,335111,358722
Vermont,M12,2010,5.7,20371,338323,358694
Vermont,M11,2010,5.7,20296,338191,358487
Vermont,M10,2010,5.1,18244,340523,358767
Vermont,M09,2010,5.6,19991,337729,357720
Vermont,M08,2010,5.6,20441,341629,362070
Vermont,M07,2010,5.9,21479,343235,364714
Vermont,M06,2010,6.1,22300,341138,363438
Vermont,M05,2010,5.9,21199,336033,357232
Vermont,M04,2010,6.6,23720,333235,356955
Vermont,M03,2010,7.0,25221,333982,359203
Vermont,M02,2010,6.9,24717,333414,358131
Vermont,M01,2010,7.0,24991,332421,357412
Vermont,M12,2009,6.1,21713,335968,357681
Vermont,M11,2009,6.0,21513,336076,357589
Vermont,M10,2009,5.5,19751,337966,357717
Vermont,M09,2009,6.0,21462,336007,357469
Vermont,M08,2009,6.2,22367,340228,362595
Vermont,M07,2009,6.6,23998,340743,364741
Vermont,M06,2009,6.9,25144,339889,365033
Vermont,M05,2009,6.8,24365,334700,359065
Vermont,M04,2009,7.5,26860,330914,357774
Vermont,M03,2009,7.6,27401,333192,360593
Vermont,M02,2009,7.1,25706,334001,359707
Vermont,M01,2009,6.8,24503,333563,358066
Vermont,M12,2008,5.3,19141,338675,357816
Vermont,M11,2008,4.9,17346,339385,356731
Vermont,M10,2008,4.1,14671,342088,356759
Vermont,M09,2008,4.5,15937,339562,355499
Vermont,M08,2008,4.3,15448,342900,358348
Vermont,M07,2008,4.4,15770,343473,359243
Vermont,M06,2008,4.5,16072,342175,358247
Vermont,M05,2008,4.2,14790,336423,351213
Vermont,M04,2008,5.0,17377,332597,349974
Vermont,M03,2008,5.1,18008,334077,352085
Vermont,M02,2008,4.9,17358,334110,351468
Vermont,M01,2008,5.0,17598,333811,351409
Vermont,M12,2007,3.9,13693,337975,351668
Vermont,M11,2007,3.8,13367,337777,351144
Vermont,M10,2007,3.4,11901,339755,351656
Vermont,M09,2007,3.8,13311,338417,351728
Vermont,M08,2007,3.7,13046,343014,356060
Vermont,M07,2007,3.8,13696,344732,358428
Vermont,M06,2007,3.9,14117,344329,358446
Vermont,M05,2007,3.7,12833,338489,351322
Vermont,M04,2007,4.4,15595,335139,350734
Vermont,M03,2007,4.6,16227,338226,354453
Vermont,M02,2007,4.5,16101,338430,354531
Vermont,M01,2007,4.6,16412,338275,354687
Vermont,M12,2006,3.5,12630,343589,356219
Vermont,M11,2006,3.5,12600,343869,356469
Vermont,M10,2006,3.1,11004,346676,357680
Vermont,M09,2006,3.5,12522,344494,357016
Vermont,M08,2006,3.5,12456,348581,361037
Vermont,M07,2006,3.6,12978,348960,361938
Vermont,M06,2006,3.7,13303,348307,361610
Vermont,M05,2006,3.3,11556,342208,353764
Vermont,M04,2006,3.8,13489,338701,352190
Vermont,M03,2006,4.2,14975,340798,355773
Vermont,M02,2006,4.2,14922,340662,355584
Vermont,M01,2006,4.3,15274,339533,354807
Vermont,M12,2005,3.2,11503,343396,354899
Vermont,M11,2005,3.2,11411,341786,353197
Vermont,M10,2005,2.9,10349,343236,353585
Vermont,M09,2005,3.2,11286,340598,351884
Vermont,M08,2005,3.2,11227,344193,355420
Vermont,M07,2005,3.3,11833,343782,355615
Vermont,M06,2005,3.4,12201,341529,353730
Vermont,M05,2005,3.1,10632,335518,346150
Vermont,M04,2005,3.8,12988,331804,344792
Vermont,M03,2005,4.1,14177,332839,347016
Vermont,M02,2005,4.1,14275,332472,346747
Vermont,M01,2005,4.2,14672,331484,346156
Vermont,M12,2004,3.3,11413,335438,346851
Vermont,M11,2004,3.3,11373,335406,346779
Vermont,M10,2004,2.8,9728,337992,347720
Vermont,M09,2004,3.2,11190,336199,347389
Vermont,M08,2004,3.2,11352,340423,351775
Vermont,M07,2004,3.4,12000,340998,352998
Vermont,M06,2004,3.6,12594,339351,351945
Vermont,M05,2004,3.4,11653,333271,344924
Vermont,M04,2004,4.1,14196,329578,343774
Vermont,M03,2004,4.5,15474,330775,346249
Vermont,M02,2004,4.5,15609,330367,345976
Vermont,M01,2004,4.8,16704,328995,345699
Vermont,M12,2003,3.8,13349,333892,347241
Vermont,M11,2003,3.9,13625,332925,346550
Vermont,M10,2003,3.4,11930,334873,346803
Vermont,M09,2003,4.1,14284,332210,346494
Vermont,M08,2003,3.8,13462,336268,349730
Vermont,M07,2003,4.1,14327,336308,350635
Vermont,M06,2003,4.2,14795,334980,349775
Vermont,M05,2003,4.0,13745,328482,342227
Vermont,M04,2003,4.8,16544,324636,341180
Vermont,M03,2003,5.0,17288,326470,343758
Vermont,M02,2003,5.0,17225,326684,343909
Vermont,M01,2003,5.1,17614,325731,343345
Vermont,M12,2002,4.0,13893,330232,344125
Vermont,M11,2002,4.1,13994,329724,343718
Vermont,M10,2002,3.4,11787,332483,344270
Vermont,M09,2002,3.8,12899,330556,343455
Vermont,M08,2002,3.8,13066,334573,347639
Vermont,M07,2002,3.8,13387,334997,348384
Vermont,M06,2002,3.9,13570,334172,347742
Vermont,M05,2002,3.6,12378,328002,340380
Vermont,M04,2002,4.2,14327,324605,338932
Vermont,M03,2002,4.5,15291,325518,340809
Vermont,M02,2002,4.4,14924,324905,339829
Vermont,M01,2002,4.4,15024,323354,338378
Vermont,M12,2001,3.4,11390,327472,338862
Vermont,M11,2001,3.5,11714,326952,338666
Vermont,M10,2001,2.8,9652,329139,338791
Vermont,M09,2001,3.1,10541,327097,337638
Vermont,M08,2001,3.1,10427,330974,341401
Vermont,M07,2001,3.2,10813,331400,342213
Vermont,M06,2001,3.3,11156,329733,340889
Vermont,M05,2001,3.0,10071,323393,333464
Vermont,M04,2001,3.6,11817,320299,332116
Vermont,M03,2001,3.7,12328,321557,333885
Vermont,M02,2001,3.6,12018,321670,333688
Vermont,M01,2001,3.7,12187,320982,333169
Vermont,M12,2000,2.6,8525,325068,333593
Vermont,M11,2000,2.8,9174,323164,332338
Vermont,M10,2000,2.3,7673,325392,333065
Vermont,M09,2000,2.7,8921,322992,331913
Vermont,M08,2000,2.6,8780,326859,335639
Vermont,M07,2000,2.7,9190,326915,336105
Vermont,M06,2000,2.8,9371,326250,335621
Vermont,M05,2000,2.5,8247,319995,328242
Vermont,M04,2000,3.0,9732,316609,326341
Vermont,M03,2000,3.1,10081,318881,328962
Vermont,M02,2000,3.2,10490,317662,328152
Vermont,M01,2000,3.4,11117,315756,326873
Utah,M12,2016,2.9,44456,1482764,1527220
Utah,M11,2016,2.7,40660,1486032,1526692
Utah,M10,2016,3.1,47409,1480462,1527871
Utah,M09,2016,3.0,46235,1475286,1521521
Utah,M08,2016,3.4,51814,1469700,1521514
Utah,M07,2016,3.6,54440,1470503,1524943
Utah,M06,2016,3.8,57738,1461777,1519515
Utah,M05,2016,3.4,50903,1453664,1504567
Utah,M04,2016,3.5,52210,1443728,1495938
Utah,M03,2016,3.8,57383,1437554,1494937
Utah,M02,2016,4.0,59836,1429856,1489692
Utah,M01,2016,3.9,58060,1425107,1483167
Utah,M12,2015,3.4,49669,1431562,1481231
Utah,M11,2015,3.1,46079,1433479,1479558
Utah,M10,2015,3.4,50352,1428691,1479043
Utah,M09,2015,3.3,48682,1421821,1470503
Utah,M08,2015,3.7,54724,1419560,1474284
Utah,M07,2015,3.9,57075,1420425,1477500
Utah,M06,2015,4.0,58843,1414561,1473404
Utah,M05,2015,3.6,53031,1408425,1461456
Utah,M04,2015,3.5,50006,1398882,1448888
Utah,M03,2015,3.8,55318,1395218,1450536
Utah,M02,2015,4.0,58285,1389912,1448197
Utah,M01,2015,3.9,56921,1387720,1444641
Utah,M12,2014,3.3,47691,1392362,1440053
Utah,M11,2014,3.2,45903,1396101,1442004
Utah,M10,2014,3.5,50818,1391719,1442537
Utah,M09,2014,3.5,49744,1384403,1434147
Utah,M08,2014,3.9,56404,1379772,1436176
Utah,M07,2014,4.0,57780,1380691,1438471
Utah,M06,2014,4.1,58880,1377138,1436018
Utah,M05,2014,3.7,52334,1371497,1423831
Utah,M04,2014,3.5,49720,1364595,1414315
Utah,M03,2014,4.2,59208,1360927,1420135
Utah,M02,2014,4.5,63807,1355738,1419545
Utah,M01,2014,4.4,62823,1355979,1418802
Utah,M12,2013,3.8,53947,1365060,1419007
Utah,M11,2013,3.7,52585,1368650,1421235
Utah,M10,2013,4.2,58898,1359648,1418546
Utah,M09,2013,4.1,58241,1356488,1414729
Utah,M08,2013,4.6,64743,1352640,1417383
Utah,M07,2013,4.8,68065,1354761,1422826
Utah,M06,2013,5.0,71335,1346179,1417514
Utah,M05,2013,4.5,63520,1339674,1403194
Utah,M04,2013,4.6,63909,1330624,1394533
Utah,M03,2013,5.0,69714,1322630,1392344
Utah,M02,2013,5.4,74536,1316368,1390904
Utah,M01,2013,5.5,76236,1312940,1389176
Utah,M12,2012,4.8,66262,1320522,1386784
Utah,M11,2012,4.5,62257,1323894,1386151
Utah,M10,2012,4.9,67806,1318705,1386511
Utah,M09,2012,4.8,65956,1311822,1377778
Utah,M08,2012,5.4,73865,1305385,1379250
Utah,M07,2012,5.5,75884,1305569,1381453
Utah,M06,2012,5.7,79294,1303068,1382362
Utah,M05,2012,5.3,72757,1296651,1369408
Utah,M04,2012,5.5,74094,1285118,1359212
Utah,M03,2012,6.0,81556,1277077,1358633
Utah,M02,2012,6.3,85873,1270343,1356216
Utah,M01,2012,6.2,84360,1267527,1351887
Utah,M12,2011,5.6,76295,1275434,1351729
Utah,M11,2011,5.6,75383,1277165,1352548
Utah,M10,2011,5.9,80254,1272864,1353118
Utah,M09,2011,6.1,82635,1268310,1350945
Utah,M08,2011,6.7,91102,1265299,1356401
Utah,M07,2011,6.8,92535,1264644,1357179
Utah,M06,2011,7.0,95303,1258199,1353502
Utah,M05,2011,6.8,91821,1253861,1345682
Utah,M04,2011,7.0,93481,1248868,1342349
Utah,M03,2011,7.5,101464,1244853,1346317
Utah,M02,2011,7.9,106447,1240984,1347431
Utah,M01,2011,7.9,106568,1241562,1348130
Utah,M12,2010,7.3,97886,1252176,1350062
Utah,M11,2010,7.1,96706,1257324,1354030
Utah,M10,2010,7.3,99605,1257809,1357414
Utah,M09,2010,7.4,100075,1255956,1356031
Utah,M08,2010,8.0,108901,1256081,1364982
Utah,M07,2010,8.0,109981,1257081,1367062
Utah,M06,2010,8.2,112133,1253877,1366010
Utah,M05,2010,7.8,105612,1250675,1356287
Utah,M04,2010,7.8,105724,1246134,1351858
Utah,M03,2010,8.4,113032,1237091,1350123
Utah,M02,2010,8.3,112208,1235034,1347242
Utah,M01,2010,8.4,113530,1238534,1352064
Utah,M12,2009,7.6,102187,1248827,1351014
Utah,M11,2009,7.2,98200,1258735,1356935
Utah,M10,2009,7.3,99374,1259663,1359037
Utah,M09,2009,7.3,98541,1259950,1358491
Utah,M08,2009,7.7,104786,1264482,1369268
Utah,M07,2009,7.7,105629,1269093,1374722
Utah,M06,2009,7.8,106663,1268986,1375649
Utah,M05,2009,7.2,97691,1267713,1365404
Utah,M04,2009,7.0,95275,1267081,1362356
Utah,M03,2009,7.3,100202,1268652,1368854
Utah,M02,2009,7.2,98703,1275082,1373785
Utah,M01,2009,6.6,90845,1283848,1374693
Utah,M12,2008,5.1,70535,1305754,1376289
Utah,M11,2008,3.6,49770,1317443,1367213
Utah,M10,2008,3.5,48463,1324616,1373079
Utah,M09,2008,3.4,46188,1325875,1372063
Utah,M08,2008,3.8,51794,1328747,1380541
Utah,M07,2008,3.7,50792,1332166,1382958
Utah,M06,2008,3.7,50401,1328604,1379005
Utah,M05,2008,3.1,42616,1324237,1366853
Utah,M04,2008,3.0,40236,1321384,1361620
Utah,M03,2008,3.4,46011,1317655,1363666
Utah,M02,2008,3.5,47227,1317064,1364291
Utah,M01,2008,3.3,45315,1321525,1366840
Utah,M12,2007,2.6,35223,1334506,1369729
Utah,M11,2007,2.3,32057,1341293,1373350
Utah,M10,2007,2.5,34291,1337414,1371705
Utah,M09,2007,2.5,33813,1332965,1366778
Utah,M08,2007,2.8,38847,1332354,1371201
Utah,M07,2007,2.8,38650,1334517,1373167
Utah,M06,2007,2.9,39349,1329724,1369073
Utah,M05,2007,2.3,31569,1320810,1352379
Utah,M04,2007,2.2,30120,1311916,1342036
Utah,M03,2007,2.5,34077,1308175,1342252
Utah,M02,2007,2.7,36307,1302667,1338974
Utah,M01,2007,2.7,36529,1302379,1338908
Utah,M12,2006,2.1,28404,1310095,1338499
Utah,M11,2006,2.1,28646,1308219,1336865
Utah,M10,2006,2.4,31355,1302521,1333876
Utah,M09,2006,2.5,32880,1294698,1327578
Utah,M08,2006,3.0,40567,1293051,1333618
Utah,M07,2006,3.2,42561,1289723,1332284
Utah,M06,2006,3.3,44074,1282447,1326521
Utah,M05,2006,3.0,39510,1270223,1309733
Utah,M04,2006,3.0,39007,1260156,1299163
Utah,M03,2006,3.5,45153,1252086,1297239
Utah,M02,2006,3.8,48808,1245989,1294797
Utah,M01,2006,3.8,48494,1242726,1291220
Utah,M12,2005,3.3,42973,1248674,1291647
Utah,M11,2005,3.4,44501,1248096,1292597
Utah,M10,2005,3.7,47762,1245352,1293114
Utah,M09,2005,3.9,49770,1237352,1287122
Utah,M08,2005,4.0,51348,1235975,1287323
Utah,M07,2005,4.2,53315,1231092,1284407
Utah,M06,2005,4.4,56410,1220678,1277088
Utah,M05,2005,4.1,51209,1211792,1263001
Utah,M04,2005,4.1,50829,1201816,1252645
Utah,M03,2005,4.5,56157,1192881,1249038
Utah,M02,2005,4.8,59307,1188066,1247373
Utah,M01,2005,4.7,58355,1185629,1243984
Utah,M12,2004,4.1,51406,1192890,1244296
Utah,M11,2004,4.2,52181,1194253,1246434
Utah,M10,2004,4.4,55254,1189304,1244558
Utah,M09,2004,4.5,56053,1181111,1237164
Utah,M08,2004,5.1,62889,1179637,1242526
Utah,M07,2004,5.2,64349,1179145,1243494
Utah,M06,2004,5.4,67204,1171817,1239021
Utah,M05,2004,5.0,61185,1162719,1223904
Utah,M04,2004,5.0,60519,1154002,1214521
Utah,M03,2004,5.6,67507,1146495,1214002
Utah,M02,2004,5.7,68631,1143495,1212126
Utah,M01,2004,5.7,69200,1142670,1211870
Utah,M12,2003,4.9,59337,1151271,1210608
Utah,M11,2003,5.0,60482,1152196,1212678
Utah,M10,2003,5.1,62061,1149095,1211156
Utah,M09,2003,5.2,63027,1141217,1204244
Utah,M08,2003,5.7,69433,1139982,1209415
Utah,M07,2003,5.8,70133,1138473,1208606
Utah,M06,2003,6.1,73507,1133355,1206862
Utah,M05,2003,5.6,66293,1125714,1192007
Utah,M04,2003,5.6,66683,1118827,1185510
Utah,M03,2003,6.1,72391,1113164,1185555
Utah,M02,2003,6.3,74711,1112675,1187386
Utah,M01,2003,6.2,74128,1114674,1188802
Utah,M12,2002,5.4,64559,1123596,1188155
Utah,M11,2002,5.5,64920,1125985,1190905
Utah,M10,2002,5.6,66575,1127083,1193658
Utah,M09,2002,5.7,67267,1122414,1189681
Utah,M08,2002,6.1,73393,1120216,1193609
Utah,M07,2002,6.1,73274,1121137,1194411
Utah,M06,2002,6.2,73974,1115958,1189932
Utah,M05,2002,5.7,67573,1111340,1178913
Utah,M04,2002,5.7,66516,1105986,1172502
Utah,M03,2002,5.9,69439,1102516,1171955
Utah,M02,2002,6.0,70386,1109869,1180255
Utah,M01,2002,5.7,66328,1106706,1173034
Utah,M12,2001,4.8,55984,1113430,1169414
Utah,M11,2001,4.4,51877,1118029,1169906
Utah,M10,2001,4.4,51646,1119316,1170962
Utah,M09,2001,4.4,51044,1116908,1167952
Utah,M08,2001,4.8,56537,1116095,1172632
Utah,M07,2001,4.6,54481,1119970,1174451
Utah,M06,2001,4.7,55027,1116018,1171045
Utah,M05,2001,4.1,47618,1111014,1158632
Utah,M04,2001,4.0,45948,1105625,1151573
Utah,M03,2001,4.4,50818,1104463,1155281
Utah,M02,2001,4.3,49631,1103364,1152995
Utah,M01,2001,4.1,47032,1107053,1154085
Utah,M12,2000,3.2,36683,1118114,1154797
Utah,M11,2000,3.2,36816,1118246,1155062
Utah,M10,2000,3.2,37375,1117076,1154451
Utah,M09,2000,3.2,37176,1110807,1147983
Utah,M08,2000,3.7,43053,1109999,1153052
Utah,M07,2000,3.6,41638,1110553,1152191
Utah,M06,2000,3.7,42740,1108156,1150896
Utah,M05,2000,3.2,35759,1099253,1135012
Utah,M04,2000,2.9,33103,1094896,1127999
Utah,M03,2000,3.3,37542,1088200,1125742
Utah,M02,2000,3.5,39328,1085291,1124619
Utah,M01,2000,3.4,37629,1085092,1122721
West Virginia,M12,2016,5.1,39261,732524,771785
West Virginia,M11,2016,5.0,38750,740379,779129
West Virginia,M10,2016,5.3,41772,746351,788123
West Virginia,M09,2016,5.4,42749,744425,787174
West Virginia,M08,2016,5.9,46854,740659,787513
West Virginia,M07,2016,5.7,45427,746267,791694
West Virginia,M06,2016,6.1,48771,747066,795837
West Virginia,M05,2016,5.8,45348,740155,785503
West Virginia,M04,2016,6.1,47580,735209,782789
West Virginia,M03,2016,6.9,53243,723685,776928
West Virginia,M02,2016,7.5,58854,722025,780879
West Virginia,M01,2016,7.2,55903,718376,774279
West Virginia,M12,2015,5.9,45944,727336,773280
West Virginia,M11,2015,5.7,44473,732601,777074
West Virginia,M10,2015,5.6,44157,739476,783633
West Virginia,M09,2015,5.9,45997,736637,782634
West Virginia,M08,2015,6.7,53018,734168,787186
West Virginia,M07,2015,7.0,55536,738650,794186
West Virginia,M06,2015,7.2,57608,741469,799077
West Virginia,M05,2015,6.9,54401,734459,788860
West Virginia,M04,2015,7.1,55517,730178,785695
West Virginia,M03,2015,7.7,59707,716517,776224
West Virginia,M02,2015,7.9,61469,716597,778066
West Virginia,M01,2015,7.4,57202,715554,772756
West Virginia,M12,2014,6.0,46600,725721,772321
West Virginia,M11,2014,5.9,45772,733296,779068
West Virginia,M10,2014,5.8,45991,742907,788898
West Virginia,M09,2014,5.9,46598,740274,786872
West Virginia,M08,2014,6.6,52421,736782,789203
West Virginia,M07,2014,6.5,51968,743849,795817
West Virginia,M06,2014,6.6,52522,748017,800539
West Virginia,M05,2014,6.4,51173,743531,794704
West Virginia,M04,2014,6.6,52312,740413,792725
West Virginia,M03,2014,7.5,59416,729273,788689
West Virginia,M02,2014,8.1,64386,727877,792263
West Virginia,M01,2014,7.7,60245,726130,786375
West Virginia,M12,2013,6.4,50394,735939,786333
West Virginia,M11,2013,6.2,48890,742921,791811
West Virginia,M10,2013,6.2,49348,747710,797058
West Virginia,M09,2013,6.0,48157,751271,799428
West Virginia,M08,2013,6.5,52157,748456,800613
West Virginia,M07,2013,6.5,52042,754426,806468
West Virginia,M06,2013,6.7,54511,756692,811203
West Virginia,M05,2013,6.3,50074,750434,800508
West Virginia,M04,2013,6.6,52713,746484,799197
West Virginia,M03,2013,7.4,58587,732921,791508
West Virginia,M02,2013,8.1,64973,732588,797561
West Virginia,M01,2013,8.3,65825,730554,796379
West Virginia,M12,2012,7.3,58062,741662,799724
West Virginia,M11,2012,7.0,56176,748070,804246
West Virginia,M10,2012,7.0,56558,756990,813548
West Virginia,M09,2012,7.0,56876,755251,812127
West Virginia,M08,2012,7.6,61697,748371,810068
West Virginia,M07,2012,7.6,61675,754368,816043
West Virginia,M06,2012,7.7,63259,758583,821842
West Virginia,M05,2012,7.3,59680,753733,813413
West Virginia,M04,2012,7.3,58716,748606,807322
West Virginia,M03,2012,7.8,62353,736612,798965
West Virginia,M02,2012,8.4,66980,734806,801786
West Virginia,M01,2012,8.1,64369,731553,795922
West Virginia,M12,2011,7.3,58843,742559,801402
West Virginia,M11,2011,7.1,57186,748538,805724
West Virginia,M10,2011,7.2,58354,753558,811912
West Virginia,M09,2011,7.5,60502,751409,811911
West Virginia,M08,2011,7.9,64025,745107,809132
West Virginia,M07,2011,7.7,62301,745837,808138
West Virginia,M06,2011,8.1,65669,748836,814505
West Virginia,M05,2011,7.8,62981,743587,806568
West Virginia,M04,2011,8.0,64921,742153,807074
West Virginia,M03,2011,8.9,71545,729612,801157
West Virginia,M02,2011,9.6,77336,727362,804698
West Virginia,M01,2011,9.6,76926,725110,802036
West Virginia,M12,2010,8.6,69522,734511,804033
West Virginia,M11,2010,8.3,67355,741204,808559
West Virginia,M10,2010,8.0,65397,748160,813557
West Virginia,M09,2010,8.1,66268,749897,816165
West Virginia,M08,2010,8.6,69883,744619,814502
West Virginia,M07,2010,8.3,68140,748313,816453
West Virginia,M06,2010,8.4,69109,749765,818874
West Virginia,M05,2010,8.3,67383,746359,813742
West Virginia,M04,2010,8.4,67894,744096,811990
West Virginia,M03,2010,9.3,74828,729279,804107
West Virginia,M02,2010,10.0,81181,727359,808540
West Virginia,M01,2010,9.4,75614,727363,802977
West Virginia,M12,2009,8.1,64642,735640,800282
West Virginia,M11,2009,7.6,61387,746812,808199
West Virginia,M10,2009,7.6,61765,752435,814200
West Virginia,M09,2009,7.5,61549,753823,815372
West Virginia,M08,2009,8.0,65521,752677,818198
West Virginia,M07,2009,8.0,66296,759674,825970
West Virginia,M06,2009,8.4,69274,760163,829437
West Virginia,M05,2009,8.0,65189,754085,819274
West Virginia,M04,2009,7.8,63645,754448,818093
West Virginia,M03,2009,7.7,61776,744926,806702
West Virginia,M02,2009,7.5,60919,747917,808836
West Virginia,M01,2009,6.5,52376,751376,803752
West Virginia,M12,2008,4.7,37823,765840,803663
West Virginia,M11,2008,4.0,32420,777140,809560
West Virginia,M10,2008,3.7,30061,786104,816165
West Virginia,M09,2008,3.6,29651,785409,815060
West Virginia,M08,2008,3.9,31980,780918,812898
West Virginia,M07,2008,3.9,31594,787844,819438
West Virginia,M06,2008,4.3,35676,787794,823470
West Virginia,M05,2008,4.3,34978,782156,817134
West Virginia,M04,2008,4.4,35564,779365,814929
West Virginia,M03,2008,5.0,40030,767272,807302
West Virginia,M02,2008,5.4,43631,765110,808741
West Virginia,M01,2008,5.1,40734,765769,806503
West Virginia,M12,2007,4.3,34835,772784,807619
West Virginia,M11,2007,4.0,32785,780646,813431
West Virginia,M10,2007,4.0,32968,783811,816779
West Virginia,M09,2007,4.2,33932,783381,817313
West Virginia,M08,2007,4.6,37303,777180,814483
West Virginia,M07,2007,4.5,37018,784050,821068
West Virginia,M06,2007,4.6,37833,783661,821494
West Virginia,M05,2007,4.4,35788,774565,810353
West Virginia,M04,2007,4.6,37178,770590,807768
West Virginia,M03,2007,5.0,40022,762127,802149
West Virginia,M02,2007,5.7,45858,757959,803817
West Virginia,M01,2007,5.1,40520,757128,797648
West Virginia,M12,2006,4.2,33382,768344,801726
West Virginia,M11,2006,4.3,34840,772840,807680
West Virginia,M10,2006,4.3,35077,777564,812641
West Virginia,M09,2006,4.7,38095,774245,812340
West Virginia,M08,2006,5.3,43171,769691,812862
West Virginia,M07,2006,5.2,42361,774483,816844
West Virginia,M06,2006,5.3,43336,775390,818726
West Virginia,M05,2006,5.0,40440,768025,808465
West Virginia,M04,2006,4.9,39610,763474,803084
West Virginia,M03,2006,5.2,41256,753737,794993
West Virginia,M02,2006,5.7,45003,750487,795490
West Virginia,M01,2006,5.2,40661,748509,789170
West Virginia,M12,2005,4.3,34185,756721,790906
West Virginia,M11,2005,4.4,35263,760220,795483
West Virginia,M10,2005,4.4,35223,764971,800194
West Virginia,M09,2005,4.7,37899,761519,799418
West Virginia,M08,2005,5.1,40973,757641,798614
West Virginia,M07,2005,5.1,41223,761223,802446
West Virginia,M06,2005,5.3,42300,758487,800787
West Virginia,M05,2005,4.9,38584,750023,788607
West Virginia,M04,2005,5.1,40165,745682,785847
West Virginia,M03,2005,5.9,45697,732416,778113
West Virginia,M02,2005,6.3,48798,729368,778166
West Virginia,M01,2005,5.8,44741,728464,773205
West Virginia,M12,2004,4.7,36787,738957,775744
West Virginia,M11,2004,4.5,35089,745610,780699
West Virginia,M10,2004,4.4,34710,750624,785334
West Virginia,M09,2004,4.4,34738,748871,783609
West Virginia,M08,2004,5.1,40043,746105,786148
West Virginia,M07,2004,5.1,40847,752617,793464
West Virginia,M06,2004,5.6,44382,750666,795048
West Virginia,M05,2004,5.3,41821,744295,786116
West Virginia,M04,2004,5.6,43930,740132,784062
West Virginia,M03,2004,6.2,48282,729002,777284
West Virginia,M02,2004,6.7,51937,728399,780336
West Virginia,M01,2004,6.3,48644,727403,776047
West Virginia,M12,2003,5.2,40184,737100,777284
West Virginia,M11,2003,5.1,39600,741793,781393
West Virginia,M10,2003,5.1,39777,746120,785897
West Virginia,M09,2003,5.3,41512,743238,784750
West Virginia,M08,2003,6.0,47080,739842,786922
West Virginia,M07,2003,6.1,48480,745789,794269
West Virginia,M06,2003,6.5,52282,746821,799103
West Virginia,M05,2003,6.1,48240,739404,787644
West Virginia,M04,2003,6.4,50386,738661,789047
West Virginia,M03,2003,6.7,52716,728991,781707
West Virginia,M02,2003,7.3,57328,729593,786921
West Virginia,M01,2003,6.8,53163,730528,783691
West Virginia,M12,2002,5.7,44881,742415,787296
West Virginia,M11,2002,5.5,43843,748760,792603
West Virginia,M10,2002,5.2,41719,757877,799596
West Virginia,M09,2002,5.3,42161,759299,801460
West Virginia,M08,2002,5.7,45907,754321,800228
West Virginia,M07,2002,5.8,46818,760453,807271
West Virginia,M06,2002,6.2,50514,761257,811771
West Virginia,M05,2002,6.0,48211,756695,804906
West Virginia,M04,2002,6.1,49200,752948,802148
West Virginia,M03,2002,6.4,51338,745090,796428
West Virginia,M02,2002,6.7,53891,747290,801181
West Virginia,M01,2002,6.4,50919,744170,795089
West Virginia,M12,2001,4.8,38526,760021,798547
West Virginia,M11,2001,4.6,36622,766214,802836
West Virginia,M10,2001,4.2,34073,773482,807555
West Virginia,M09,2001,4.2,33989,774516,808505
West Virginia,M08,2001,4.7,37782,769407,807189
West Virginia,M07,2001,4.6,37385,780513,817898
West Virginia,M06,2001,5.0,41200,780327,821527
West Virginia,M05,2001,4.8,39048,772823,811871
West Virginia,M04,2001,5.2,42016,770412,812428
West Virginia,M03,2001,5.7,45937,761514,807451
West Virginia,M02,2001,6.2,50317,758576,808893
West Virginia,M01,2001,6.1,48704,756129,804833
West Virginia,M12,2000,5.1,40850,766507,807357
West Virginia,M11,2000,5.0,40515,768113,808628
West Virginia,M10,2000,4.8,38575,771846,810421
West Virginia,M09,2000,4.8,39090,769903,808993
West Virginia,M08,2000,5.2,42017,766545,808562
West Virginia,M07,2000,5.1,42009,775020,817029
West Virginia,M06,2000,5.6,45831,775897,821728
West Virginia,M05,2000,5.4,43708,767117,810825
West Virginia,M04,2000,5.4,43809,765211,809020
West Virginia,M03,2000,6.0,48285,753020,801305
West Virginia,M02,2000,6.9,55693,750148,805841
West Virginia,M01,2000,6.5,51838,747206,799044
Nevada,M12,2016,4.9,70178,1358835,1429013
Nevada,M11,2016,5.0,71570,1362050,1433620
Nevada,M10,2016,5.2,73890,1359082,1432972
Nevada,M09,2016,5.4,77259,1355089,1432348
Nevada,M08,2016,5.5,79024,1350149,1429173
Nevada,M07,2016,5.8,83557,1352055,1435612
Nevada,M06,2016,6.0,84989,1342977,1427966
Nevada,M05,2016,5.7,80669,1343165,1423834
Nevada,M04,2016,5.9,83327,1337274,1420601
Nevada,M03,2016,6.1,86979,1335084,1422063
Nevada,M02,2016,6.2,88608,1333661,1422269
Nevada,M01,2016,6.6,93218,1322670,1415888
Nevada,M12,2015,6.2,87584,1328549,1416133
Nevada,M11,2015,6.3,89016,1331303,1420319
Nevada,M10,2015,6.3,89592,1329075,1418667
Nevada,M09,2015,6.6,93825,1323351,1417176
Nevada,M08,2015,6.7,95558,1321565,1417123
Nevada,M07,2015,7.0,99706,1321971,1421677
Nevada,M06,2015,7.0,99356,1318979,1418335
Nevada,M05,2015,6.7,94176,1321064,1415240
Nevada,M04,2015,7.0,98549,1313484,1412033
Nevada,M03,2015,7.0,98901,1308780,1407681
Nevada,M02,2015,7.3,102204,1307018,1409222
Nevada,M01,2015,7.6,106390,1296533,1402923
Nevada,M12,2014,7.2,100685,1297921,1398606
Nevada,M11,2014,7.3,101810,1301144,1402954
Nevada,M10,2014,7.3,101705,1300200,1401905
Nevada,M09,2014,7.5,104999,1293956,1398955
Nevada,M08,2014,7.7,107773,1289154,1396927
Nevada,M07,2014,8.1,112955,1288687,1401642
Nevada,M06,2014,8.1,112452,1284174,1396626
Nevada,M05,2014,7.8,109097,1284909,1394006
Nevada,M04,2014,8.0,111483,1276772,1388255
Nevada,M03,2014,8.6,119418,1273948,1393366
Nevada,M02,2014,8.6,119348,1269804,1389152
Nevada,M01,2014,9.0,123879,1258221,1382100
Nevada,M12,2013,8.6,117883,1258999,1376882
Nevada,M11,2013,8.6,119227,1261981,1381208
Nevada,M10,2013,8.9,122244,1256002,1378246
Nevada,M09,2013,9.2,126922,1255889,1382811
Nevada,M08,2013,9.4,130303,1254169,1384472
Nevada,M07,2013,9.7,135144,1255763,1390907
Nevada,M06,2013,9.9,137104,1251224,1388328
Nevada,M05,2013,9.6,132712,1250351,1383063
Nevada,M04,2013,9.8,135455,1243622,1379077
Nevada,M03,2013,10.1,140015,1240129,1380144
Nevada,M02,2013,10.3,142763,1239164,1381927
Nevada,M01,2013,10.8,149291,1229338,1378629
Nevada,M12,2012,10.4,142637,1233000,1375637
Nevada,M11,2012,10.3,141534,1237163,1378697
Nevada,M10,2012,10.4,143357,1236750,1380107
Nevada,M09,2012,10.7,148000,1231448,1379448
Nevada,M08,2012,11.0,152082,1226446,1378528
Nevada,M07,2012,11.4,157182,1226851,1384033
Nevada,M06,2012,11.3,156200,1223248,1379448
Nevada,M05,2012,11.2,153618,1222635,1376253
Nevada,M04,2012,11.4,156750,1214367,1371117
Nevada,M03,2012,11.7,160967,1211563,1372530
Nevada,M02,2012,11.9,163557,1209886,1373443
Nevada,M01,2012,12.3,168172,1199167,1367339
Nevada,M12,2011,12.3,168123,1203894,1372017
Nevada,M11,2011,12.3,169504,1206386,1375890
Nevada,M10,2011,12.5,171639,1204231,1375870
Nevada,M09,2011,12.9,176949,1199247,1376196
Nevada,M08,2011,13.1,179743,1196466,1376209
Nevada,M07,2011,13.1,181299,1197478,1378777
Nevada,M06,2011,13.2,181084,1192570,1373654
Nevada,M05,2011,12.9,177229,1194554,1371783
Nevada,M04,2011,13.2,181060,1189796,1370856
Nevada,M03,2011,13.4,183466,1186514,1369980
Nevada,M02,2011,13.6,185903,1184716,1370619
Nevada,M01,2011,13.9,190211,1175321,1365532
Nevada,M12,2010,13.6,185477,1177561,1363038
Nevada,M11,2010,13.6,185224,1178768,1363992
Nevada,M10,2010,13.4,182818,1177600,1360418
Nevada,M09,2010,13.7,186389,1174624,1361013
Nevada,M08,2010,13.5,184021,1177064,1361085
Nevada,M07,2010,13.7,186753,1178113,1364866
Nevada,M06,2010,13.5,183759,1175242,1359001
Nevada,M05,2010,13.3,180306,1177567,1357873
Nevada,M04,2010,13.4,182115,1174945,1357060
Nevada,M03,2010,13.6,183360,1169191,1352551
Nevada,M02,2010,13.5,183187,1170586,1353773
Nevada,M01,2010,13.5,182244,1166032,1348276
Nevada,M12,2009,12.5,168039,1173763,1341802
Nevada,M11,2009,12.1,162942,1180812,1343754
Nevada,M10,2009,12.0,161372,1181920,1343292
Nevada,M09,2009,12.0,160837,1183517,1344354
Nevada,M08,2009,11.7,158218,1188795,1347013
Nevada,M07,2009,11.7,157934,1194991,1352925
Nevada,M06,2009,11.5,155062,1196331,1351393
Nevada,M05,2009,10.8,145865,1202241,1348106
Nevada,M04,2009,10.6,143344,1205749,1349093
Nevada,M03,2009,10.5,141383,1210208,1351591
Nevada,M02,2009,10.2,139209,1220080,1359289
Nevada,M01,2009,10.0,136289,1222690,1358979
Nevada,M12,2008,9.0,122140,1239385,1361525
Nevada,M11,2008,8.2,111588,1254286,1365874
Nevada,M10,2008,7.6,103867,1264970,1368837
Nevada,M09,2008,7.2,98892,1269223,1368115
Nevada,M08,2008,7.0,95415,1275199,1370614
Nevada,M07,2008,6.7,92102,1281349,1373451
Nevada,M06,2008,6.4,87047,1281246,1368293
Nevada,M05,2008,5.8,79214,1284143,1363357
Nevada,M04,2008,5.8,78770,1282079,1360849
Nevada,M03,2008,5.6,76373,1279716,1356089
Nevada,M02,2008,5.6,75510,1279677,1355187
Nevada,M01,2008,5.6,75722,1274968,1350690
Nevada,M12,2007,4.9,65731,1279987,1345718
Nevada,M11,2007,4.6,62498,1283013,1345511
Nevada,M10,2007,4.5,60397,1278925,1339322
Nevada,M09,2007,4.6,62121,1274109,1336230
Nevada,M08,2007,4.5,60625,1273356,1333981
Nevada,M07,2007,4.6,61758,1274351,1336109
Nevada,M06,2007,4.5,59842,1271501,1331343
Nevada,M05,2007,4.1,54469,1270563,1325032
Nevada,M04,2007,4.3,56625,1264205,1320830
Nevada,M03,2007,4.3,56331,1263865,1320196
Nevada,M02,2007,4.4,57490,1261593,1319083
Nevada,M01,2007,4.6,60006,1251393,1311399
Nevada,M12,2006,4.0,52150,1256645,1308795
Nevada,M11,2006,3.9,50433,1256562,1306995
Nevada,M10,2006,3.8,49411,1253802,1303213
Nevada,M09,2006,4.0,52085,1247368,1299453
Nevada,M08,2006,4.0,52522,1245096,1297618
Nevada,M07,2006,4.2,54831,1240611,1295442
Nevada,M06,2006,4.2,54309,1234242,1288551
Nevada,M05,2006,3.9,49639,1228558,1278197
Nevada,M04,2006,4.1,52466,1219108,1271574
Nevada,M03,2006,4.1,51573,1213709,1265282
Nevada,M02,2006,4.1,51800,1208092,1259892
Nevada,M01,2006,4.3,53150,1195653,1248803
Nevada,M12,2005,3.7,46459,1197384,1243843
Nevada,M11,2005,3.9,47926,1195719,1243645
Nevada,M10,2005,3.9,48074,1192346,1240420
Nevada,M09,2005,4.1,50456,1185815,1236271
Nevada,M08,2005,4.0,49938,1183240,1233178
Nevada,M07,2005,4.3,52910,1180322,1233232
Nevada,M06,2005,4.3,52914,1172690,1225604
Nevada,M05,2005,3.9,47555,1169620,1217175
Nevada,M04,2005,4.0,48524,1163616,1212140
Nevada,M03,2005,4.1,49299,1154493,1203792
Nevada,M02,2005,4.3,52129,1149544,1201673
Nevada,M01,2005,4.6,55284,1139716,1195000
Nevada,M12,2004,4.0,48270,1144718,1192988
Nevada,M11,2004,4.0,47461,1146301,1193762
Nevada,M10,2004,3.8,45815,1144307,1190122
Nevada,M09,2004,4.1,48243,1136558,1184801
Nevada,M08,2004,4.1,48312,1134393,1182705
Nevada,M07,2004,4.4,51663,1132974,1184637
Nevada,M06,2004,4.4,52414,1125467,1177881
Nevada,M05,2004,4.1,47722,1122280,1170002
Nevada,M04,2004,4.3,50709,1116395,1167104
Nevada,M03,2004,4.6,53766,1110356,1164122
Nevada,M02,2004,4.7,54972,1108525,1163497
Nevada,M01,2004,5.1,58943,1101041,1159984
Nevada,M12,2003,4.5,52543,1103409,1155952
Nevada,M11,2003,4.7,54044,1103662,1157706
Nevada,M10,2003,4.7,53918,1101348,1155266
Nevada,M09,2003,5.0,57196,1095418,1152614
Nevada,M08,2003,4.9,56857,1093903,1150760
Nevada,M07,2003,5.2,60398,1091103,1151501
Nevada,M06,2003,5.4,61573,1085573,1147146
Nevada,M05,2003,4.9,56039,1084173,1140212
Nevada,M04,2003,5.2,58960,1079155,1138115
Nevada,M03,2003,5.3,60207,1078635,1138842
Nevada,M02,2003,5.4,61679,1078857,1140536
Nevada,M01,2003,5.8,65572,1070205,1135777
Nevada,M12,2002,5.3,60128,1073654,1133782
Nevada,M11,2002,5.2,59144,1075591,1134735
Nevada,M10,2002,5.1,57423,1077415,1134838
Nevada,M09,2002,5.2,58974,1074207,1133181
Nevada,M08,2002,5.3,60092,1072979,1133071
Nevada,M07,2002,5.7,64304,1071028,1135332
Nevada,M06,2002,5.7,64264,1065871,1130135
Nevada,M05,2002,5.4,60875,1065946,1126821
Nevada,M04,2002,5.8,64737,1059731,1124468
Nevada,M03,2002,6.0,67462,1056887,1124349
Nevada,M02,2002,6.2,69985,1055138,1125123
Nevada,M01,2002,6.7,75170,1045000,1120170
Nevada,M12,2001,6.1,68379,1052936,1121315
Nevada,M11,2001,5.9,66540,1055273,1121813
Nevada,M10,2001,5.9,65884,1055598,1121482
Nevada,M09,2001,5.0,56098,1063816,1119914
Nevada,M08,2001,5.0,56337,1061658,1117995
Nevada,M07,2001,5.0,56475,1063291,1119766
Nevada,M06,2001,5.0,55316,1058135,1113451
Nevada,M05,2001,4.6,50754,1055365,1106119
Nevada,M04,2001,4.9,53803,1049637,1103440
Nevada,M03,2001,4.8,53359,1048800,1102159
Nevada,M02,2001,4.9,54495,1047684,1102179
Nevada,M01,2001,5.1,56365,1038956,1095321
Nevada,M12,2000,4.4,48224,1040229,1088453
Nevada,M11,2000,4.4,47669,1040078,1087747
Nevada,M10,2000,4.2,45821,1038026,1083847
Nevada,M09,2000,4.3,46215,1034299,1080514
Nevada,M08,2000,4.0,42918,1033629,1076547
Nevada,M07,2000,4.1,44318,1029153,1073471
Nevada,M06,2000,4.1,44146,1022699,1066845
Nevada,M05,2000,3.8,39690,1018236,1057926
Nevada,M04,2000,3.9,41247,1011205,1052452
Nevada,M03,2000,4.1,43426,1004938,1048364
Nevada,M02,2000,4.2,44324,1002769,1047093
Nevada,M01,2000,4.5,46721,994288,1041009
Indiana,M12,2016,4.0,131025,3156507,3287532
Indiana,M11,2016,3.9,127730,3188283,3316013
Indiana,M10,2016,3.9,130358,3198332,3328690
Indiana,M09,2016,4.0,134378,3190894,3325272
Indiana,M08,2016,4.4,147078,3187093,3334171
Indiana,M07,2016,4.4,147172,3213443,3360615
Indiana,M06,2016,4.6,153573,3213959,3367532
Indiana,M05,2016,4.2,140717,3201606,3342323
Indiana,M04,2016,4.5,148441,3182951,3331392
Indiana,M03,2016,5.1,170289,3157311,3327600
Indiana,M02,2016,5.1,169356,3141213,3310569
Indiana,M01,2016,5.0,164921,3126080,3291001
Indiana,M12,2015,4.6,151023,3142148,3293171
Indiana,M11,2015,4.5,148566,3148277,3296843
Indiana,M10,2015,4.3,140534,3148352,3288886
Indiana,M09,2015,4.1,134789,3126109,3260898
Indiana,M08,2015,4.5,146848,3124475,3271323
Indiana,M07,2015,4.7,154722,3141090,3295812
Indiana,M06,2015,4.8,159616,3152561,3312177
Indiana,M05,2015,4.9,159744,3133034,3292778
Indiana,M04,2015,4.5,145431,3104132,3249563
Indiana,M03,2015,5.3,169772,3061311,3231083
Indiana,M02,2015,5.6,181723,3045016,3226739
Indiana,M01,2015,6.1,197636,3041517,3239153
Indiana,M12,2014,5.5,177591,3053606,3231197
Indiana,M11,2014,5.7,184641,3070211,3254852
Indiana,M10,2014,5.4,176554,3078441,3254995
Indiana,M09,2014,5.3,172366,3050476,3222842
Indiana,M08,2014,5.9,190207,3040945,3231152
Indiana,M07,2014,6.1,198349,3063233,3261582
Indiana,M06,2014,5.9,193788,3071311,3265099
Indiana,M05,2014,5.9,190807,3050252,3241059
Indiana,M04,2014,5.5,177333,3027744,3205077
Indiana,M03,2014,6.6,212638,2993513,3206151
Indiana,M02,2014,6.9,221505,2965748,3187253
Indiana,M01,2014,6.6,208416,2956658,3165074
Indiana,M12,2013,6.3,202067,2980774,3182841
Indiana,M11,2013,6.6,210969,2995910,3206879
Indiana,M10,2013,6.9,218768,2973527,3192295
Indiana,M09,2013,6.8,218292,2975583,3193875
Indiana,M08,2013,7.3,233279,2966539,3199818
Indiana,M07,2013,7.7,247873,2975362,3223235
Indiana,M06,2013,8.1,261554,2973621,3235175
Indiana,M05,2013,7.8,248480,2950916,3199396
Indiana,M04,2013,7.5,237472,2931665,3169137
Indiana,M03,2013,8.4,266419,2889649,3156068
Indiana,M02,2013,9.0,284907,2877466,3162373
Indiana,M01,2013,9.6,302796,2867670,3170466
Indiana,M12,2012,8.5,269186,2895862,3165048
Indiana,M11,2012,8.0,251879,2914971,3166850
Indiana,M10,2012,7.8,249270,2934262,3183532
Indiana,M09,2012,7.7,244251,2917849,3162100
Indiana,M08,2012,8.4,265065,2898525,3163590
Indiana,M07,2012,8.6,274758,2915835,3190593
Indiana,M06,2012,8.4,270647,2935366,3206013
Indiana,M05,2012,8.0,253390,2923615,3177005
Indiana,M04,2012,7.7,242795,2904726,3147521
Indiana,M03,2012,8.6,272469,2883663,3156132
Indiana,M02,2012,9.1,286733,2873096,3159829
Indiana,M01,2012,9.2,290986,2868823,3159809
Indiana,M12,2011,8.7,277085,2902051,3179136
Indiana,M11,2011,8.7,279123,2917677,3196800
Indiana,M10,2011,8.9,286568,2926371,3212939
Indiana,M09,2011,9.0,288198,2913160,3201358
Indiana,M08,2011,9.4,302056,2897375,3199431
Indiana,M07,2011,9.4,303283,2908166,3211449
Indiana,M06,2011,9.3,298386,2917342,3215728
Indiana,M05,2011,8.7,277975,2911835,3189810
Indiana,M04,2011,8.4,264539,2892033,3156572
Indiana,M03,2011,9.2,289264,2857532,3146796
Indiana,M02,2011,9.6,301388,2832204,3133592
Indiana,M01,2011,10.0,312687,2827588,3140275
Indiana,M12,2010,9.2,290079,2846447,3136526
Indiana,M11,2010,9.6,301817,2856743,3158560
Indiana,M10,2010,9.3,295824,2869580,3165404
Indiana,M09,2010,9.5,300333,2863615,3163948
Indiana,M08,2010,10.1,323906,2871468,3195374
Indiana,M07,2010,10.3,331800,2884969,3216769
Indiana,M06,2010,10.4,332933,2881377,3214310
Indiana,M05,2010,10.3,328378,2868075,3196453
Indiana,M04,2010,10.6,337846,2857046,3194892
Indiana,M03,2010,11.6,367860,2794861,3162721
Indiana,M02,2010,11.8,373103,2776722,3149825
Indiana,M01,2010,11.8,371132,2776388,3147520
Indiana,M12,2009,10.7,334172,2795775,3129947
Indiana,M11,2009,10.1,318350,2834803,3153153
Indiana,M10,2009,10.2,321740,2841370,3163110
Indiana,M09,2009,10.0,315104,2841836,3156940
Indiana,M08,2009,10.3,327432,2858499,3185931
Indiana,M07,2009,10.5,338775,2887946,3226721
Indiana,M06,2009,10.8,351270,2901243,3252513
Indiana,M05,2009,10.4,335850,2889192,3225042
Indiana,M04,2009,9.9,316230,2888917,3205147
Indiana,M03,2009,10.7,343739,2864368,3208107
Indiana,M02,2009,10.4,333790,2876314,3210104
Indiana,M01,2009,9.7,311593,2899557,3211150
Indiana,M12,2008,8.1,261955,2961505,3223460
Indiana,M11,2008,6.8,221204,3010296,3231500
Indiana,M10,2008,6.2,200017,3048708,3248725
Indiana,M09,2008,5.7,185331,3045917,3231248
Indiana,M08,2008,6.2,200408,3057948,3258356
Indiana,M07,2008,6.1,200016,3083442,3283458
Indiana,M06,2008,5.7,185640,3088028,3273668
Indiana,M05,2008,5.2,168854,3071026,3239880
Indiana,M04,2008,4.6,147863,3059494,3207357
Indiana,M03,2008,5.4,173428,3028009,3201437
Indiana,M02,2008,5.3,170221,3018871,3189092
Indiana,M01,2008,5.3,168288,3028691,3196979
Indiana,M12,2007,4.7,149241,3053535,3202776
Indiana,M11,2007,4.3,137384,3081817,3219201
Indiana,M10,2007,4.0,129841,3076502,3206343
Indiana,M09,2007,4.2,133028,3064775,3197803
Indiana,M08,2007,4.4,141131,3056722,3197853
Indiana,M07,2007,4.6,147068,3082410,3229478
Indiana,M06,2007,4.5,146858,3087002,3233860
Indiana,M05,2007,4.2,135658,3063607,3199265
Indiana,M04,2007,4.4,140909,3052453,3193362
Indiana,M03,2007,4.8,153770,3047548,3201318
Indiana,M02,2007,5.3,169778,3028234,3198012
Indiana,M01,2007,5.4,175076,3037904,3212980
Indiana,M12,2006,4.6,149350,3085079,3234429
Indiana,M11,2006,4.6,148182,3091047,3239229
Indiana,M10,2006,4.3,139601,3104055,3243656
Indiana,M09,2006,4.6,148142,3074488,3222630
Indiana,M08,2006,5.1,166469,3079166,3245635
Indiana,M07,2006,5.4,176071,3094998,3271069
Indiana,M06,2006,5.1,168205,3102012,3270217
Indiana,M05,2006,5.1,165673,3077683,3243356
Indiana,M04,2006,5.0,162804,3062968,3225772
Indiana,M03,2006,5.4,173921,3042566,3216487
Indiana,M02,2006,5.8,185563,3028189,3213752
Indiana,M01,2006,5.4,171980,3023108,3195088
Indiana,M12,2005,5.2,166068,3046547,3212615
Indiana,M11,2005,5.3,171759,3056458,3228217
Indiana,M10,2005,5.0,161923,3072072,3233995
Indiana,M09,2005,5.2,165752,3048131,3213883
Indiana,M08,2005,5.2,167308,3054073,3221381
Indiana,M07,2005,5.4,174277,3068060,3242337
Indiana,M06,2005,5.4,173522,3059890,3233412
Indiana,M05,2005,5.2,166228,3038976,3205204
Indiana,M04,2005,5.3,168110,3018730,3186840
Indiana,M03,2005,6.0,189316,2976330,3165646
Indiana,M02,2005,6.5,206368,2962476,3168844
Indiana,M01,2005,6.2,195090,2957759,3152849
Indiana,M12,2004,5.5,173333,2986940,3160273
Indiana,M11,2004,5.3,169947,3007425,3177372
Indiana,M10,2004,5.1,162002,3012362,3174364
Indiana,M09,2004,4.8,152616,2998152,3150768
Indiana,M08,2004,5.1,163132,3007600,3170732
Indiana,M07,2004,5.5,175674,3035019,3210693
Indiana,M06,2004,5.3,169789,3027629,3197418
Indiana,M05,2004,5.1,160183,3006956,3167139
Indiana,M04,2004,5.0,157282,2995993,3153275
Indiana,M03,2004,5.9,186633,2967012,3153645
Indiana,M02,2004,5.8,181541,2962705,3144246
Indiana,M01,2004,5.9,184611,2969019,3153630
Indiana,M12,2003,5.0,158305,2998145,3156450
Indiana,M11,2003,5.0,160054,3017127,3177181
Indiana,M10,2003,4.8,154307,3029339,3183646
Indiana,M09,2003,5.0,158069,3012177,3170246
Indiana,M08,2003,5.4,174137,3022911,3197048
Indiana,M07,2003,5.8,186196,3037244,3223440
Indiana,M06,2003,5.7,183600,3047367,3230967
Indiana,M05,2003,5.1,161746,3027821,3189567
Indiana,M04,2003,5.0,157346,3017690,3175036
Indiana,M03,2003,5.5,174809,2993390,3168199
Indiana,M02,2003,5.6,177058,2987056,3164114
Indiana,M01,2003,5.5,174363,2985596,3159959
Indiana,M12,2002,4.8,152678,3005278,3157956
Indiana,M11,2002,4.9,153976,3014029,3168005
Indiana,M10,2002,4.5,142661,3038928,3181589
Indiana,M09,2002,4.4,139419,3038475,3177894
Indiana,M08,2002,5.0,159830,3034749,3194579
Indiana,M07,2002,5.2,165639,3045918,3211557
Indiana,M06,2002,5.4,171944,3031711,3203655
Indiana,M05,2002,5.0,159965,3013449,3173414
Indiana,M04,2002,5.3,167988,2988398,3156386
Indiana,M03,2002,5.8,182371,2965880,3148251
Indiana,M02,2002,5.9,185568,2964204,3149772
Indiana,M01,2002,6.1,190239,2940710,3130949
Indiana,M12,2001,5.2,164595,2980275,3144870
Indiana,M11,2001,5.0,156134,2990976,3147110
Indiana,M10,2001,4.5,141562,3008685,3150247
Indiana,M09,2001,4.1,127032,3004485,3131517
Indiana,M08,2001,4.4,136563,2994055,3130618
Indiana,M07,2001,4.1,129473,3028844,3158317
Indiana,M06,2001,4.1,129475,3029198,3158673
Indiana,M05,2001,3.6,113805,3020560,3134365
Indiana,M04,2001,3.7,114909,3017940,3132849
Indiana,M03,2001,4.2,133077,3010797,3143874
Indiana,M02,2001,4.0,124699,2999927,3124626
Indiana,M01,2001,4.1,129381,3004347,3133728
Indiana,M12,2000,2.9,89804,3025893,3115697
Indiana,M11,2000,2.7,84510,3024861,3109371
Indiana,M10,2000,2.2,69358,3034123,3103481
Indiana,M09,2000,2.3,71797,3021106,3092903
Indiana,M08,2000,3.1,96190,3025659,3121849
Indiana,M07,2000,3.3,102308,3044157,3146465
Indiana,M06,2000,3.3,105613,3062016,3167629
Indiana,M05,2000,3.2,101122,3039902,3141024
Indiana,M04,2000,3.0,95209,3041582,3136791
Indiana,M03,2000,3.8,119887,3016073,3135960
Indiana,M02,2000,3.8,118873,3005745,3124618
Indiana,M01,2000,3.6,112995,3007761,3120756
South Carolina,M12,2016,4.2,95277,2188435,2283712
South Carolina,M11,2016,4.0,91905,2193995,2285900
South Carolina,M10,2016,4.5,102913,2196432,2299345
South Carolina,M09,2016,4.7,108274,2193283,2301557
South Carolina,M08,2016,5.1,117129,2199424,2316553
South Carolina,M07,2016,5.0,115692,2211721,2327413
South Carolina,M06,2016,5.3,122678,2206380,2329058
South Carolina,M05,2016,4.5,103766,2198216,2301982
South Carolina,M04,2016,4.7,107506,2187727,2295233
South Carolina,M03,2016,5.1,117246,2172349,2289595
South Carolina,M02,2016,5.4,124139,2154107,2278246
South Carolina,M01,2016,5.6,126284,2138812,2265096
South Carolina,M12,2015,5.4,122137,2144885,2267022
South Carolina,M11,2015,5.3,120874,2144644,2265518
South Carolina,M10,2015,5.6,128545,2148518,2277063
South Carolina,M09,2015,5.6,127761,2136682,2264443
South Carolina,M08,2015,6.0,136531,2147367,2283898
South Carolina,M07,2015,6.1,139916,2157480,2297396
South Carolina,M06,2015,6.3,146163,2157445,2303608
South Carolina,M05,2015,6.1,138364,2148638,2287002
South Carolina,M04,2015,5.8,130454,2132624,2263078
South Carolina,M03,2015,6.0,135347,2113276,2248623
South Carolina,M02,2015,6.6,148656,2096729,2245385
South Carolina,M01,2015,6.9,154201,2087358,2241559
South Carolina,M12,2014,6.4,143637,2092697,2236334
South Carolina,M11,2014,6.5,146273,2098000,2244273
South Carolina,M10,2014,6.6,148398,2102894,2251292
South Carolina,M09,2014,6.8,153146,2087897,2241043
South Carolina,M08,2014,7.3,164576,2090348,2254924
South Carolina,M07,2014,7.0,157499,2101262,2258761
South Carolina,M06,2014,6.6,148265,2103986,2252251
South Carolina,M05,2014,5.9,130643,2092953,2223596
South Carolina,M04,2014,5.3,115851,2079991,2195842
South Carolina,M03,2014,6.0,130605,2061517,2192122
South Carolina,M02,2014,6.4,138854,2036992,2175846
South Carolina,M01,2014,6.5,140067,2029596,2169663
South Carolina,M12,2013,6.2,134045,2033424,2167469
South Carolina,M11,2013,6.5,142009,2037127,2179136
South Carolina,M10,2013,7.1,155536,2035513,2191049
South Carolina,M09,2013,7.3,159590,2036728,2196318
South Carolina,M08,2013,7.8,172097,2040909,2213006
South Carolina,M07,2013,7.9,176263,2051322,2227585
South Carolina,M06,2013,8.3,186534,2050163,2236697
South Carolina,M05,2013,7.7,169316,2039253,2208569
South Carolina,M04,2013,7.4,161516,2024634,2186150
South Carolina,M03,2013,7.8,168781,2003815,2172596
South Carolina,M02,2013,8.6,186963,1988382,2175345
South Carolina,M01,2013,9.1,199113,1978722,2177835
South Carolina,M12,2012,8.6,186783,1988777,2175560
South Carolina,M11,2012,8.2,177723,1995770,2173493
South Carolina,M10,2012,8.6,188394,2001739,2190133
South Carolina,M09,2012,8.6,187423,1993560,2180983
South Carolina,M08,2012,9.5,208935,1993290,2202225
South Carolina,M07,2012,9.8,216722,2004254,2220976
South Carolina,M06,2012,9.8,217906,2007780,2225686
South Carolina,M05,2012,9.2,201232,1997340,2198572
South Carolina,M04,2012,8.8,192077,1984566,2176643
South Carolina,M03,2012,9.3,202027,1970073,2172100
South Carolina,M02,2012,10.0,216670,1950978,2167648
South Carolina,M01,2012,10.2,219223,1939283,2158506
South Carolina,M12,2011,9.9,213746,1944904,2158650
South Carolina,M11,2011,10.0,215727,1950528,2166255
South Carolina,M10,2011,10.3,225551,1955757,2181308
South Carolina,M09,2011,10.7,232937,1952512,2185449
South Carolina,M08,2011,11.0,241219,1959957,2201176
South Carolina,M07,2011,10.8,238045,1967170,2205215
South Carolina,M06,2011,11.1,245228,1965610,2210838
South Carolina,M05,2011,10.3,225692,1960348,2186040
South Carolina,M04,2011,10.0,217904,1951050,2168954
South Carolina,M03,2011,10.3,221237,1931493,2152730
South Carolina,M02,2011,11.0,235186,1910955,2146141
South Carolina,M01,2011,11.3,243009,1900520,2143529
South Carolina,M12,2010,10.8,231105,1909521,2140626
South Carolina,M11,2010,10.9,233542,1913708,2147250
South Carolina,M10,2010,10.5,225348,1924161,2149509
South Carolina,M09,2010,10.7,231578,1923986,2155564
South Carolina,M08,2010,11.2,244749,1934786,2179535
South Carolina,M07,2010,11.0,240106,1944223,2184329
South Carolina,M06,2010,11.2,244208,1940423,2184631
South Carolina,M05,2010,10.7,232874,1935363,2168237
South Carolina,M04,2010,10.9,234476,1923094,2157570
South Carolina,M03,2010,11.5,246337,1892633,2138970
South Carolina,M02,2010,12.1,258345,1873551,2131896
South Carolina,M01,2010,12.4,264804,1865089,2129893
South Carolina,M12,2009,11.5,244006,1871007,2115013
South Carolina,M11,2009,11.3,239246,1885248,2124494
South Carolina,M10,2009,11.5,245972,1893706,2139678
South Carolina,M09,2009,11.5,245694,1895141,2140835
South Carolina,M08,2009,11.5,247965,1914687,2162652
South Carolina,M07,2009,11.6,253471,1932518,2185989
South Carolina,M06,2009,11.9,260682,1932513,2193195
South Carolina,M05,2009,11.1,240131,1928193,2168324
South Carolina,M04,2009,10.7,231231,1927688,2158919
South Carolina,M03,2009,10.9,233805,1916263,2150068
South Carolina,M02,2009,11.0,236254,1912099,2148353
South Carolina,M01,2009,10.6,226448,1918980,2145428
South Carolina,M12,2008,9.1,194839,1947636,2142475
South Carolina,M11,2008,8.0,172247,1968061,2140308
South Carolina,M10,2008,7.8,167350,1988007,2155357
South Carolina,M09,2008,7.5,160318,1990871,2151189
South Carolina,M08,2008,7.5,162877,2003086,2165963
South Carolina,M07,2008,6.9,149774,2022393,2172167
South Carolina,M06,2008,6.6,143842,2028477,2172319
South Carolina,M05,2008,5.8,125026,2020770,2145796
South Carolina,M04,2008,5.2,111086,2014582,2125668
South Carolina,M03,2008,5.4,114751,2001879,2116630
South Carolina,M02,2008,5.7,120822,1986471,2107293
South Carolina,M01,2008,6.0,126942,1984680,2111622
South Carolina,M12,2007,5.8,121614,1992861,2114475
South Carolina,M11,2007,5.4,114045,2003260,2117305
South Carolina,M10,2007,5.6,118189,2008101,2126290
South Carolina,M09,2007,5.6,119816,2008234,2128050
South Carolina,M08,2007,5.7,121989,2015875,2137864
South Carolina,M07,2007,5.8,125358,2031889,2157247
South Carolina,M06,2007,5.9,126476,2033179,2159655
South Carolina,M05,2007,5.1,109037,2016656,2125693
South Carolina,M04,2007,5.2,109810,2006452,2116262
South Carolina,M03,2007,5.3,111834,1999346,2111180
South Carolina,M02,2007,6.1,128040,1978774,2106814
South Carolina,M01,2007,6.5,136253,1973600,2109853
South Carolina,M12,2006,6.0,127512,1988319,2115831
South Carolina,M11,2006,6.2,131898,1987069,2118967
South Carolina,M10,2006,6.2,132168,1993816,2125984
South Carolina,M09,2006,6.5,136708,1975831,2112539
South Carolina,M08,2006,6.8,144597,1983077,2127674
South Carolina,M07,2006,6.6,140914,1991364,2132278
South Carolina,M06,2006,6.8,145432,1986443,2131875
South Carolina,M05,2006,6.2,131361,1982159,2113520
South Carolina,M04,2006,6.1,128541,1973345,2101886
South Carolina,M03,2006,6.2,128852,1956622,2085474
South Carolina,M02,2006,6.8,141100,1936679,2077779
South Carolina,M01,2006,6.8,140031,1925320,2065351
South Carolina,M12,2005,6.7,138832,1930038,2068870
South Carolina,M11,2005,6.9,143139,1938067,2081206
South Carolina,M10,2005,6.9,144029,1946301,2090330
South Carolina,M09,2005,6.9,144265,1936875,2081140
South Carolina,M08,2005,6.8,143232,1951693,2094925
South Carolina,M07,2005,6.6,138812,1958566,2097378
South Carolina,M06,2005,6.9,144673,1944665,2089338
South Carolina,M05,2005,6.2,128542,1937632,2066174
South Carolina,M04,2005,6.1,126271,1927665,2053936
South Carolina,M03,2005,6.4,129621,1905284,2034905
South Carolina,M02,2005,7.2,146155,1890305,2036460
South Carolina,M01,2005,7.1,144825,1883708,2028533
South Carolina,M12,2004,6.8,138995,1895432,2034427
South Carolina,M11,2004,6.8,139685,1902007,2041692
South Carolina,M10,2004,6.7,137930,1908631,2046561
South Carolina,M09,2004,6.7,136406,1901029,2037435
South Carolina,M08,2004,6.9,142607,1912307,2054914
South Carolina,M07,2004,7.0,143733,1922691,2066424
South Carolina,M06,2004,7.3,151443,1916197,2067640
South Carolina,M05,2004,6.4,130967,1902942,2033909
South Carolina,M04,2004,6.3,126604,1892348,2018952
South Carolina,M03,2004,6.7,135065,1873233,2008298
South Carolina,M02,2004,7.0,140383,1854802,1995185
South Carolina,M01,2004,7.3,146215,1848068,1994283
South Carolina,M12,2003,6.7,133811,1856377,1990188
South Carolina,M11,2003,6.9,138247,1859920,1998167
South Carolina,M10,2003,6.8,137265,1868030,2005295
South Carolina,M09,2003,7.0,139070,1861824,2000894
South Carolina,M08,2003,7.1,142440,1872690,2015130
South Carolina,M07,2003,7.2,146902,1881913,2028815
South Carolina,M06,2003,7.6,155600,1879929,2035529
South Carolina,M05,2003,6.5,129929,1869473,1999402
South Carolina,M04,2003,6.3,125403,1861942,1987345
South Carolina,M03,2003,6.4,126125,1848505,1974630
South Carolina,M02,2003,7.0,138924,1832966,1971890
South Carolina,M01,2003,7.4,144824,1823607,1968431
South Carolina,M12,2002,5.9,114920,1830126,1945046
South Carolina,M11,2002,5.9,116031,1834275,1950306
South Carolina,M10,2002,5.6,110060,1849106,1959166
South Carolina,M09,2002,5.6,108956,1846486,1955442
South Carolina,M08,2002,5.9,115827,1854282,1970109
South Carolina,M07,2002,5.7,113287,1860878,1974165
South Carolina,M06,2002,6.1,121434,1859786,1981220
South Carolina,M05,2002,5.4,105443,1848646,1954089
South Carolina,M04,2002,5.5,105923,1835845,1941768
South Carolina,M03,2002,5.7,110090,1818355,1928445
South Carolina,M02,2002,6.1,116756,1802528,1919284
South Carolina,M01,2002,6.3,121011,1789561,1910572
South Carolina,M12,2001,5.8,110516,1808579,1919095
South Carolina,M11,2001,5.6,108344,1815526,1923870
South Carolina,M10,2001,5.7,111085,1828165,1939250
South Carolina,M09,2001,5.5,106572,1833484,1940056
South Carolina,M08,2001,5.8,113325,1845237,1958562
South Carolina,M07,2001,5.4,106394,1867137,1973531
South Carolina,M06,2001,5.6,109879,1866052,1975931
South Carolina,M05,2001,4.7,91219,1863784,1955003
South Carolina,M04,2001,4.5,88263,1863680,1951943
South Carolina,M03,2001,4.6,90186,1863274,1953460
South Carolina,M02,2001,4.8,94319,1856807,1951126
South Carolina,M01,2001,4.6,90844,1863548,1954392
South Carolina,M12,2000,3.7,72211,1895075,1967286
South Carolina,M11,2000,3.4,67542,1912546,1980088
South Carolina,M10,2000,3.4,67503,1919558,1987061
South Carolina,M09,2000,3.7,74132,1909050,1983182
South Carolina,M08,2000,4.2,83866,1924212,2008078
South Carolina,M07,2000,3.9,78948,1937989,2016937
South Carolina,M06,2000,4.1,83583,1956290,2039873
South Carolina,M05,2000,3.6,73283,1938239,2011522
South Carolina,M04,2000,3.2,63244,1930111,1993355
South Carolina,M03,2000,3.5,69941,1915475,1985416
South Carolina,M02,2000,4.1,81161,1896544,1977705
South Carolina,M01,2000,4.3,84332,1887905,1972237
Texas,M12,2016,4.5,605992,12747329,13353321
Texas,M11,2016,4.5,599870,12771219,13371089
Texas,M10,2016,4.6,612866,12725859,13338725
Texas,M09,2016,4.8,646980,12712681,13359661
Texas,M08,2016,4.9,656216,12638955,13295171
Texas,M07,2016,5.1,674961,12681873,13356834
Texas,M06,2016,5.0,662948,12656717,13319665
Texas,M05,2016,4.3,566379,12679140,13245519
Texas,M04,2016,4.3,564001,12672854,13236855
Texas,M03,2016,4.5,590841,12648877,13239718
Texas,M02,2016,4.4,581318,12604648,13185966
Texas,M01,2016,4.5,591497,12521460,13112957
Texas,M12,2015,4.2,552984,12540698,13093682
Texas,M11,2015,4.4,579425,12533049,13112474
Texas,M10,2015,4.4,578499,12497269,13075768
Texas,M09,2015,4.5,583360,12449651,13033011
Texas,M08,2015,4.6,596865,12420060,13016925
Texas,M07,2015,4.8,630680,12451762,13082442
Texas,M06,2015,4.7,619670,12466343,13086013
Texas,M05,2015,4.3,563808,12506184,13069992
Texas,M04,2015,4.0,526184,12492598,13018782
Texas,M03,2015,4.3,556687,12427747,12984434
Texas,M02,2015,4.4,574706,12404530,12979236
Texas,M01,2015,4.7,609832,12366482,12976314
Texas,M12,2014,4.2,541484,12410089,12951573
Texas,M11,2014,4.5,590599,12438759,13029358
Texas,M10,2014,4.6,599382,12440400,13039782
Texas,M09,2014,4.9,639045,12371374,13010419
Texas,M08,2014,5.4,695628,12298759,12994387
Texas,M07,2014,5.6,730679,12348734,13079413
Texas,M06,2014,5.4,710460,12357463,13067923
Texas,M05,2014,5.0,656576,12359038,13015614
Texas,M04,2014,4.8,619308,12355821,12975129
Texas,M03,2014,5.4,708292,12301419,13009711
Texas,M02,2014,5.7,733529,12230191,12963720
Texas,M01,2014,5.7,740348,12174755,12915103
Texas,M12,2013,5.4,694318,12201560,12895878
Texas,M11,2013,5.7,732866,12186923,12919789
Texas,M10,2013,6.0,766759,12089215,12855974
Texas,M09,2013,6.1,790406,12140240,12930646
Texas,M08,2013,6.3,812972,12059050,12872022
Texas,M07,2013,6.6,857908,12094347,12952255
Texas,M06,2013,6.8,884426,12079177,12963603
Texas,M05,2013,6.2,797952,12094475,12892427
Texas,M04,2013,6.0,766256,12073849,12840105
Texas,M03,2013,6.2,798905,11985122,12784027
Texas,M02,2013,6.5,830739,11952051,12782790
Texas,M01,2013,6.9,883249,11893690,12776939
Texas,M12,2012,6.2,791201,11968650,12759851
Texas,M11,2012,6.1,772543,11970972,12743515
Texas,M10,2012,6.2,797319,11971813,12769132
Texas,M09,2012,6.4,809805,11909369,12719174
Texas,M08,2012,6.9,873812,11769217,12643029
Texas,M07,2012,7.3,931555,11796327,12727882
Texas,M06,2012,7.3,933622,11798739,12732361
Texas,M05,2012,6.7,844076,11806442,12650518
Texas,M04,2012,6.4,805537,11786190,12591727
Texas,M03,2012,6.8,859410,11741389,12600799
Texas,M02,2012,7.1,890894,11687054,12577948
Texas,M01,2012,7.3,911588,11617933,12529521
Texas,M12,2011,6.9,870603,11714861,12585464
Texas,M11,2011,7.1,893500,11702257,12595757
Texas,M10,2011,7.5,938526,11655694,12594220
Texas,M09,2011,7.9,989432,11607339,12596771
Texas,M08,2011,8.0,1007986,11520653,12528639
Texas,M07,2011,8.3,1039997,11501175,12541172
Texas,M06,2011,8.4,1054438,11491101,12545539
Texas,M05,2011,7.6,948802,11518020,12466822
Texas,M04,2011,7.4,924948,11518006,12442954
Texas,M03,2011,7.7,960466,11463514,12423980
Texas,M02,2011,8.0,984454,11390426,12374880
Texas,M01,2011,8.3,1019687,11338090,12357777
Texas,M12,2010,7.8,962812,11385991,12348803
Texas,M11,2010,8.1,1001853,11362655,12364508
Texas,M10,2010,7.8,963964,11350286,12314250
Texas,M09,2010,8.0,982925,11333517,12316442
Texas,M08,2010,8.2,1011330,11274649,12285979
Texas,M07,2010,8.4,1037014,11261587,12298601
Texas,M06,2010,8.4,1029896,11238521,12268417
Texas,M05,2010,7.9,960234,11260078,12220312
Texas,M04,2010,7.9,965539,11289475,12255014
Texas,M03,2010,8.3,1001101,11127084,12128185
Texas,M02,2010,8.4,1012252,11055561,12067813
Texas,M01,2010,8.6,1039130,10996179,12035309
Texas,M12,2009,8.0,952707,11013116,11965823
Texas,M11,2009,8.0,956207,11062079,12018286
Texas,M10,2009,8.1,975533,11011595,11987128
Texas,M09,2009,8.3,1000259,10990178,11990437
Texas,M08,2009,8.4,1009840,10994483,12004323
Texas,M07,2009,8.6,1035741,11040828,12076569
Texas,M06,2009,8.5,1022430,11018811,12041241
Texas,M05,2009,7.3,868282,11013839,11882121
Texas,M04,2009,6.1,724529,11059651,11784180
Texas,M03,2009,6.5,763112,10968499,11731611
Texas,M02,2009,6.5,764512,10965224,11729736
Texas,M01,2009,6.4,749603,10968533,11718136
Texas,M12,2008,5.5,641504,11110725,11752229
Texas,M11,2008,5.2,617765,11162021,11779786
Texas,M10,2008,5.1,600302,11188769,11789071
Texas,M09,2008,5.1,593741,11146305,11740046
Texas,M08,2008,5.2,607364,11094921,11702285
Texas,M07,2008,5.2,606120,11151531,11757651
Texas,M06,2008,5.0,587493,11124221,11711714
Texas,M05,2008,4.4,506759,11097095,11603854
Texas,M04,2008,3.9,451636,11132636,11584272
Texas,M03,2008,4.2,489116,11051758,11540874
Texas,M02,2008,4.3,493903,10992699,11486602
Texas,M01,2008,4.6,527599,10996695,11524294
Texas,M12,2007,4.2,483652,11049555,11533207
Texas,M11,2007,4.1,474029,11075735,11549764
Texas,M10,2007,4.0,462928,11011656,11474584
Texas,M09,2007,4.3,496580,10980926,11477506
Texas,M08,2007,4.3,491278,10904772,11396050
Texas,M07,2007,4.7,535176,10971424,11506600
Texas,M06,2007,4.6,529279,10940718,11469997
Texas,M05,2007,4.0,449863,10903461,11353324
Texas,M04,2007,4.0,448557,10901324,11349881
Texas,M03,2007,4.1,464933,10897097,11362030
Texas,M02,2007,4.5,509904,10831239,11341143
Texas,M01,2007,4.7,536436,10829049,11365485
Texas,M12,2006,4.1,466737,10956317,11423054
Texas,M11,2006,4.4,506468,10925350,11431818
Texas,M10,2006,4.3,495411,10910614,11406025
Texas,M09,2006,4.7,537698,10813585,11351283
Texas,M08,2006,5.0,565943,10782048,11347991
Texas,M07,2006,5.4,610041,10792293,11402334
Texas,M06,2006,5.4,615971,10765207,11381178
Texas,M05,2006,4.9,551935,10725868,11277803
Texas,M04,2006,4.9,547441,10722411,11269852
Texas,M03,2006,5.0,560206,10680046,11240252
Texas,M02,2006,5.3,593738,10623673,11217411
Texas,M01,2006,5.3,590476,10596465,11186941
Texas,M12,2005,5.0,562663,10683767,11246430
Texas,M11,2005,5.3,592268,10664565,11256833
Texas,M10,2005,5.0,564306,10683461,11247767
Texas,M09,2005,5.3,589810,10593348,11183158
Texas,M08,2005,5.4,600394,10540998,11141392
Texas,M07,2005,5.6,623335,10543440,11166775
Texas,M06,2005,5.7,632359,10493434,11125793
Texas,M05,2005,5.2,575497,10484012,11059509
Texas,M04,2005,5.2,572930,10479958,11052888
Texas,M03,2005,5.4,597597,10405736,11003333
Texas,M02,2005,5.9,647892,10364448,11012340
Texas,M01,2005,5.9,652742,10341922,10994664
Texas,M12,2004,5.5,612261,10441331,11053592
Texas,M11,2004,5.7,632532,10440639,11073171
Texas,M10,2004,5.6,615958,10417859,11033817
Texas,M09,2004,5.7,621936,10356976,10978912
Texas,M08,2004,5.8,638902,10345375,10984277
Texas,M07,2004,6.2,684628,10376617,11061245
Texas,M06,2004,6.4,708911,10326304,11035215
Texas,M05,2004,5.7,627992,10305181,10933173
Texas,M04,2004,5.7,627430,10313069,10940499
Texas,M03,2004,6.2,682846,10264007,10946853
Texas,M02,2004,6.2,672619,10251062,10923681
Texas,M01,2004,6.6,720484,10223390,10943874
Texas,M12,2003,5.8,637758,10299023,10936781
Texas,M11,2003,6.3,688886,10284220,10973106
Texas,M10,2003,6.3,688930,10253725,10942655
Texas,M09,2003,6.7,728228,10183161,10911389
Texas,M08,2003,6.9,750831,10154551,10905382
Texas,M07,2003,7.1,782978,10174388,10957366
Texas,M06,2003,7.6,833565,10181411,11014976
Texas,M05,2003,6.6,718430,10157338,10875768
Texas,M04,2003,6.5,709538,10191357,10900895
Texas,M03,2003,6.6,722674,10145641,10868315
Texas,M02,2003,6.8,735308,10117563,10852871
Texas,M01,2003,7.0,755097,10081368,10836465
Texas,M12,2002,6.2,674628,10155201,10829829
Texas,M11,2002,6.4,696834,10127279,10824113
Texas,M10,2002,6.1,666012,10171631,10837643
Texas,M09,2002,6.3,680412,10142022,10822434
Texas,M08,2002,6.5,702904,10067035,10769939
Texas,M07,2002,6.7,725927,10072312,10798239
Texas,M06,2002,6.9,746614,10050236,10796850
Texas,M05,2002,6.1,654192,10043631,10697823
Texas,M04,2002,6.2,659628,10032749,10692377
Texas,M03,2002,6.2,657376,10014687,10672063
Texas,M02,2002,6.1,653584,10006953,10660537
Texas,M01,2002,6.4,677168,9906699,10583867
Texas,M12,2001,5.6,596798,10035821,10632619
Texas,M11,2001,5.7,602489,10001479,10603968
Texas,M10,2001,5.4,570954,10021659,10592613
Texas,M09,2001,5.3,560366,9997055,10557421
Texas,M08,2001,5.4,567122,9923604,10490726
Texas,M07,2001,5.2,549574,10032984,10582558
Texas,M06,2001,5.3,559974,10001811,10561785
Texas,M05,2001,4.4,462514,10011118,10473632
Texas,M04,2001,4.3,453909,10036171,10490080
Texas,M03,2001,4.3,454943,10052547,10507490
Texas,M02,2001,4.1,430972,10018096,10449068
Texas,M01,2001,4.3,450622,10000205,10450827
Texas,M12,2000,3.5,363245,10080686,10443931
Texas,M11,2000,3.9,406582,10009575,10416157
Texas,M10,2000,3.9,401938,9986863,10388801
Texas,M09,2000,4.2,432010,9916073,10348083
Texas,M08,2000,4.4,459102,9885445,10344547
Texas,M07,2000,4.5,469465,9917421,10386886
Texas,M06,2000,4.7,487765,9931329,10419094
Texas,M05,2000,4.3,438808,9883756,10322564
Texas,M04,2000,4.0,415653,9949362,10365015
Texas,M03,2000,4.6,473019,9900447,10373466
Texas,M02,2000,4.7,490214,9864368,10354582
Texas,M01,2000,4.8,498187,9827315,10325502
Delaware,M12,2016,3.9,18141,452177,470318
Delaware,M11,2016,3.8,18029,452252,470281
Delaware,M10,2016,4.2,19814,450390,470204
Delaware,M09,2016,4.3,20185,447700,467885
Delaware,M08,2016,4.5,21262,453696,474958
Delaware,M07,2016,4.6,21762,456362,478124
Delaware,M06,2016,4.7,22505,454846,477351
Delaware,M05,2016,4.1,19240,452648,471888
Delaware,M04,2016,4.3,20229,453509,473738
Delaware,M03,2016,4.5,21451,452553,474004
Delaware,M02,2016,4.8,22590,448896,471486
Delaware,M01,2016,4.9,23227,448649,471876
Delaware,M12,2015,4.1,19572,453519,473091
Delaware,M11,2015,4.2,19875,452520,472395
Delaware,M10,2015,4.6,21871,449027,470898
Delaware,M09,2015,4.8,22182,444140,466322
Delaware,M08,2015,5.0,23372,448439,471811
Delaware,M07,2015,5.0,23658,449515,473173
Delaware,M06,2015,5.1,24229,446636,470865
Delaware,M05,2015,4.6,21399,442804,464203
Delaware,M04,2015,4.8,22223,441527,463750
Delaware,M03,2015,5.0,23329,438964,462293
Delaware,M02,2015,5.3,24397,434487,458884
Delaware,M01,2015,5.5,25060,433974,459034
Delaware,M12,2014,4.6,21001,438539,459540
Delaware,M11,2014,4.7,21609,437069,458678
Delaware,M10,2014,5.2,23998,433268,457266
Delaware,M09,2014,5.5,24941,428002,452943
Delaware,M08,2014,5.8,26741,431923,458664
Delaware,M07,2014,5.9,27334,432698,460032
Delaware,M06,2014,6.1,28008,429539,457547
Delaware,M05,2014,5.6,25205,424738,449943
Delaware,M04,2014,5.8,26128,422654,448782
Delaware,M03,2014,6.2,27758,419705,447463
Delaware,M02,2014,6.5,28856,415176,444032
Delaware,M01,2014,6.6,29250,414860,444110
Delaware,M12,2013,5.7,25293,419499,444792
Delaware,M11,2013,5.7,25383,418807,444190
Delaware,M10,2013,6.1,27203,415272,442475
Delaware,M09,2013,6.3,27701,411146,438847
Delaware,M08,2013,6.6,29277,415171,444448
Delaware,M07,2013,6.8,30351,415872,446223
Delaware,M06,2013,7.1,31550,413347,444897
Delaware,M05,2013,6.6,28966,410447,439413
Delaware,M04,2013,6.9,30559,410585,441144
Delaware,M03,2013,7.3,32376,409145,441521
Delaware,M02,2013,7.7,33810,406413,440223
Delaware,M01,2013,7.8,34474,407299,441773
Delaware,M12,2012,6.8,30416,414061,444477
Delaware,M11,2012,6.7,29994,414696,444690
Delaware,M10,2012,7.1,31572,412966,444538
Delaware,M09,2012,7.2,31661,409472,441133
Delaware,M08,2012,7.4,32899,414576,447475
Delaware,M07,2012,7.4,33237,417105,450342
Delaware,M06,2012,7.4,33459,416330,449789
Delaware,M05,2012,6.8,30296,414372,444668
Delaware,M04,2012,7.1,31498,414490,445988
Delaware,M03,2012,7.3,32715,413316,446031
Delaware,M02,2012,7.6,33736,409847,443583
Delaware,M01,2012,7.6,33892,410248,444140
Delaware,M12,2011,6.7,30066,416315,446381
Delaware,M11,2011,6.7,29978,415791,445769
Delaware,M10,2011,7.2,31781,412687,444468
Delaware,M09,2011,7.3,32277,408474,440751
Delaware,M08,2011,7.5,33466,413040,446506
Delaware,M07,2011,7.6,33846,414352,448198
Delaware,M06,2011,7.7,34533,412206,446739
Delaware,M05,2011,7.1,31433,409291,440724
Delaware,M04,2011,7.5,33017,409226,442243
Delaware,M03,2011,7.9,34796,406629,441425
Delaware,M02,2011,8.3,36575,401913,438488
Delaware,M01,2011,8.5,37352,401105,438457
Delaware,M12,2010,7.6,33552,405344,438896
Delaware,M11,2010,7.7,33636,403977,437613
Delaware,M10,2010,8.0,34871,401169,436040
Delaware,M09,2010,8.1,35218,397471,432689
Delaware,M08,2010,8.3,36480,402510,438990
Delaware,M07,2010,8.4,37002,403644,440646
Delaware,M06,2010,8.6,37552,400989,438541
Delaware,M05,2010,8.1,34923,396965,431888
Delaware,M04,2010,8.5,36614,395441,432055
Delaware,M03,2010,9.0,38614,391557,430171
Delaware,M02,2010,9.4,40140,387293,427433
Delaware,M01,2010,9.3,40001,388069,428070
Delaware,M12,2009,8.4,36157,393690,429847
Delaware,M11,2009,8.3,35491,394660,430151
Delaware,M10,2009,8.4,36285,393642,429927
Delaware,M09,2009,8.4,36109,392067,428176
Delaware,M08,2009,8.4,36758,400219,436977
Delaware,M07,2009,8.4,37193,404599,441792
Delaware,M06,2009,8.6,38079,405253,443332
Delaware,M05,2009,8.0,35059,404447,439506
Delaware,M04,2009,8.1,35716,406252,441968
Delaware,M03,2009,8.2,36451,406161,442612
Delaware,M02,2009,8.2,36334,405730,442064
Delaware,M01,2009,7.8,34628,409018,443646
Delaware,M12,2008,6.3,28269,417562,445831
Delaware,M11,2008,5.9,26140,420096,446236
Delaware,M10,2008,5.8,25736,420216,445952
Delaware,M09,2008,5.4,24029,418528,442557
Delaware,M08,2008,5.2,23604,426055,449659
Delaware,M07,2008,4.9,22251,429951,452202
Delaware,M06,2008,4.8,21464,429863,451327
Delaware,M05,2008,4.0,17700,428112,445812
Delaware,M04,2008,4.0,17962,429276,447238
Delaware,M03,2008,4.2,18900,427985,446885
Delaware,M02,2008,4.4,19720,425141,444861
Delaware,M01,2008,4.4,19752,426188,445940
Delaware,M12,2007,3.4,15164,431829,446993
Delaware,M11,2007,3.2,14230,431758,445988
Delaware,M10,2007,3.4,14991,429038,444029
Delaware,M09,2007,3.2,14197,425409,439606
Delaware,M08,2007,3.2,14436,430607,445043
Delaware,M07,2007,3.4,15196,432747,447943
Delaware,M06,2007,3.6,15898,431074,446972
Delaware,M05,2007,3.0,13219,427649,440868
Delaware,M04,2007,3.4,15125,426989,442114
Delaware,M03,2007,3.7,16449,425706,442155
Delaware,M02,2007,3.9,17228,422809,440037
Delaware,M01,2007,3.9,16995,424126,441121
Delaware,M12,2006,2.9,12981,430229,443210
Delaware,M11,2006,2.9,12988,429732,442720
Delaware,M10,2006,3.3,14504,427024,441528
Delaware,M09,2006,3.4,14988,422530,437518
Delaware,M08,2006,3.6,15861,428039,443900
Delaware,M07,2006,3.6,16201,429909,446110
Delaware,M06,2006,3.8,16684,428133,444817
Delaware,M05,2006,3.3,14298,424780,439078
Delaware,M04,2006,3.5,15580,424041,439621
Delaware,M03,2006,3.9,17029,422259,439288
Delaware,M02,2006,4.3,18786,418833,437619
Delaware,M01,2006,4.4,19517,419275,438792
Delaware,M12,2005,3.8,16834,424249,441083
Delaware,M11,2005,3.8,16702,423438,440140
Delaware,M10,2005,4.1,18112,420242,438354
Delaware,M09,2005,4.1,17866,415330,433196
Delaware,M08,2005,4.2,18460,419769,438229
Delaware,M07,2005,4.3,19066,420094,439160
Delaware,M06,2005,4.5,19591,416696,436287
Delaware,M05,2005,3.7,15981,412600,428581
Delaware,M04,2005,3.9,16606,410796,427402
Delaware,M03,2005,4.2,17780,406947,424727
Delaware,M02,2005,4.5,18918,401982,420900
Delaware,M01,2005,4.6,19411,401431,420842
Delaware,M12,2004,3.6,15374,406331,421705
Delaware,M11,2004,3.6,15098,406290,421388
Delaware,M10,2004,3.9,16319,404011,420330
Delaware,M09,2004,4.0,16814,400111,416925
Delaware,M08,2004,4.1,17418,405904,423322
Delaware,M07,2004,4.1,17655,408182,425837
Delaware,M06,2004,4.2,17823,406599,424422
Delaware,M05,2004,3.5,14699,403427,418126
Delaware,M04,2004,3.9,16167,403153,419320
Delaware,M03,2004,4.2,17570,401809,419379
Delaware,M02,2004,4.4,18149,398629,416778
Delaware,M01,2004,4.4,18328,398743,417071
Delaware,M12,2003,3.5,14721,403544,418265
Delaware,M11,2003,3.5,14738,402864,417602
Delaware,M10,2003,3.9,16116,399897,416013
Delaware,M09,2003,4.1,16972,395008,411980
Delaware,M08,2003,4.4,18530,399888,418418
Delaware,M07,2003,4.5,18818,401354,420172
Delaware,M06,2003,4.6,19106,399571,418677
Delaware,M05,2003,3.9,16084,396050,412134
Delaware,M04,2003,4.4,18058,395203,413261
Delaware,M03,2003,4.8,19771,393272,413043
Delaware,M02,2003,4.9,20088,390618,410706
Delaware,M01,2003,4.7,19255,392399,411654
Delaware,M12,2002,3.6,14743,398846,413589
Delaware,M11,2002,3.4,14255,399095,413350
Delaware,M10,2002,3.7,15095,397785,412880
Delaware,M09,2002,3.7,15366,395087,410453
Delaware,M08,2002,4.0,16504,400967,417471
Delaware,M07,2002,4.1,17130,403322,420452
Delaware,M06,2002,4.4,18319,402211,420530
Delaware,M05,2002,3.8,15872,400549,416421
Delaware,M04,2002,4.2,17671,401357,419028
Delaware,M03,2002,4.4,18384,401057,419441
Delaware,M02,2002,4.5,18930,399439,418369
Delaware,M01,2002,4.5,18897,400513,419410
Delaware,M12,2001,3.3,13999,407745,421744
Delaware,M11,2001,3.1,12881,408645,421526
Delaware,M10,2001,3.2,13412,406782,420194
Delaware,M09,2001,3.2,13236,403297,416533
Delaware,M08,2001,3.3,14063,408967,423030
Delaware,M07,2001,3.3,14244,411673,425917
Delaware,M06,2001,3.5,14902,410265,425167
Delaware,M05,2001,2.9,12255,407589,419844
Delaware,M04,2001,3.4,14153,407611,421764
Delaware,M03,2001,3.8,16212,406563,422775
Delaware,M02,2001,4.4,18355,402649,421004
Delaware,M01,2001,4.6,19322,402615,421937
Delaware,M12,2000,3.5,14809,407330,422139
Delaware,M11,2000,3.3,13808,405521,419329
Delaware,M10,2000,3.5,14721,401751,416472
Delaware,M09,2000,3.6,15021,397019,412040
Delaware,M08,2000,3.9,16130,402011,418141
Delaware,M07,2000,3.9,16409,403288,419697
Delaware,M06,2000,4.0,16811,400662,417473
Delaware,M05,2000,3.4,13941,396151,410092
Delaware,M04,2000,3.6,14815,395227,410042
Delaware,M03,2000,3.9,15718,392405,408123
Delaware,M02,2000,4.1,16775,387781,404556
Delaware,M01,2000,4.1,16722,387182,403904
Oklahoma,M12,2016,4.6,83463,1737708,1821171
Oklahoma,M11,2016,4.6,84586,1752619,1837205
Oklahoma,M10,2016,4.8,88124,1745350,1833474
Oklahoma,M09,2016,4.9,89975,1737075,1827050
Oklahoma,M08,2016,5.1,92321,1727825,1820146
Oklahoma,M07,2016,5.1,93412,1737809,1831221
Oklahoma,M06,2016,5.4,99152,1740467,1839619
Oklahoma,M05,2016,4.9,89887,1732532,1822419
Oklahoma,M04,2016,4.5,82586,1741770,1824356
Oklahoma,M03,2016,4.8,87435,1745099,1832534
Oklahoma,M02,2016,4.9,90386,1737646,1828032
Oklahoma,M01,2016,4.8,87307,1736439,1823746
Oklahoma,M12,2015,4.3,79353,1752777,1832130
Oklahoma,M11,2015,4.3,80218,1767232,1847450
Oklahoma,M10,2015,4.4,80611,1762258,1842869
Oklahoma,M09,2015,4.3,78365,1754735,1833100
Oklahoma,M08,2015,4.3,79552,1749827,1829379
Oklahoma,M07,2015,4.5,83210,1760375,1843585
Oklahoma,M06,2015,4.9,90153,1764290,1854443
Oklahoma,M05,2015,4.6,84181,1753987,1838168
Oklahoma,M04,2015,4.0,72993,1756294,1829287
Oklahoma,M03,2015,4.1,75597,1749592,1825189
Oklahoma,M02,2015,4.4,79891,1736471,1816362
Oklahoma,M01,2015,4.4,80229,1731407,1811636
Oklahoma,M12,2014,3.9,69730,1738277,1808007
Oklahoma,M11,2014,4.0,73644,1746853,1820497
Oklahoma,M10,2014,4.1,74678,1737761,1812439
Oklahoma,M09,2014,4.2,75493,1720609,1796102
Oklahoma,M08,2014,4.4,77993,1707949,1785942
Oklahoma,M07,2014,4.5,81561,1713961,1795522
Oklahoma,M06,2014,4.8,86547,1714083,1800630
Oklahoma,M05,2014,4.6,81510,1698743,1780253
Oklahoma,M04,2014,4.1,72924,1702017,1774941
Oklahoma,M03,2014,4.8,85344,1698894,1784238
Oklahoma,M02,2014,5.2,93345,1685641,1778986
Oklahoma,M01,2014,5.3,94766,1686732,1781498
Oklahoma,M12,2013,4.9,88565,1701671,1790236
Oklahoma,M11,2013,5.1,92269,1719189,1811458
Oklahoma,M10,2013,5.4,96820,1708110,1804930
Oklahoma,M09,2013,5.3,95044,1714389,1809433
Oklahoma,M08,2013,5.2,94138,1708833,1802971
Oklahoma,M07,2013,5.3,97002,1720215,1817217
Oklahoma,M06,2013,5.7,104751,1724666,1829417
Oklahoma,M05,2013,5.3,96401,1714497,1810898
Oklahoma,M04,2013,4.8,86442,1715325,1801767
Oklahoma,M03,2013,5.1,92553,1707736,1800289
Oklahoma,M02,2013,5.6,100091,1696301,1796392
Oklahoma,M01,2013,5.8,104050,1693619,1797669
Oklahoma,M12,2012,5.2,94130,1716186,1810316
Oklahoma,M11,2012,5.0,91778,1731044,1822822
Oklahoma,M10,2012,5.2,95071,1729648,1824719
Oklahoma,M09,2012,5.1,92980,1719780,1812760
Oklahoma,M08,2012,5.2,94416,1707439,1801855
Oklahoma,M07,2012,5.4,97037,1716660,1813697
Oklahoma,M06,2012,5.5,100506,1723187,1823693
Oklahoma,M05,2012,5.1,92047,1707759,1799806
Oklahoma,M04,2012,4.6,82699,1707336,1790035
Oklahoma,M03,2012,5.1,90598,1699414,1790012
Oklahoma,M02,2012,5.6,100360,1681254,1781614
Oklahoma,M01,2012,5.8,103634,1671383,1775017
Oklahoma,M12,2011,5.6,99369,1686222,1785591
Oklahoma,M11,2011,5.6,100299,1693906,1794205
Oklahoma,M10,2011,5.9,104865,1684949,1789814
Oklahoma,M09,2011,5.8,103946,1679303,1783249
Oklahoma,M08,2011,5.9,103871,1668435,1772306
Oklahoma,M07,2011,5.9,104928,1671240,1776168
Oklahoma,M06,2011,6.2,111143,1674593,1785736
Oklahoma,M05,2011,5.7,101082,1665096,1766178
Oklahoma,M04,2011,5.3,92783,1667883,1760666
Oklahoma,M03,2011,5.8,101468,1657929,1759397
Oklahoma,M02,2011,6.4,111748,1636887,1748635
Oklahoma,M01,2011,6.6,115468,1634572,1750040
Oklahoma,M12,2010,6.3,110491,1652089,1762580
Oklahoma,M11,2010,6.5,115176,1661378,1776554
Oklahoma,M10,2010,6.5,114972,1657987,1772959
Oklahoma,M09,2010,6.5,114952,1652909,1767861
Oklahoma,M08,2010,6.6,117304,1654052,1771356
Oklahoma,M07,2010,6.7,118609,1661825,1780434
Oklahoma,M06,2010,7.0,126163,1664150,1790313
Oklahoma,M05,2010,6.8,121062,1650748,1771810
Oklahoma,M04,2010,6.5,114276,1655011,1769287
Oklahoma,M03,2010,7.0,122261,1631954,1754215
Oklahoma,M02,2010,7.6,133624,1619032,1752656
Oklahoma,M01,2010,7.6,132864,1616523,1749387
Oklahoma,M12,2009,6.7,117339,1629497,1746836
Oklahoma,M11,2009,6.6,117209,1651167,1768376
Oklahoma,M10,2009,6.9,121730,1645560,1767290
Oklahoma,M09,2009,6.8,119691,1645616,1765307
Oklahoma,M08,2009,6.6,117820,1654932,1772752
Oklahoma,M07,2009,6.4,115087,1669234,1784321
Oklahoma,M06,2009,6.8,121145,1671495,1792640
Oklahoma,M05,2009,6.5,115558,1653794,1769352
Oklahoma,M04,2009,5.7,101187,1660606,1761793
Oklahoma,M03,2009,6.0,105832,1648735,1754567
Oklahoma,M02,2009,5.8,100938,1644664,1745602
Oklahoma,M01,2009,5.5,95374,1648977,1744351
Oklahoma,M12,2008,4.5,78568,1678386,1756954
Oklahoma,M11,2008,4.1,72889,1697240,1770129
Oklahoma,M10,2008,4.0,71530,1699539,1771069
Oklahoma,M09,2008,3.7,65530,1692544,1758074
Oklahoma,M08,2008,3.8,65950,1689027,1754977
Oklahoma,M07,2008,3.7,65842,1697611,1763453
Oklahoma,M06,2008,4.0,70949,1695631,1766580
Oklahoma,M05,2008,3.5,61531,1677065,1738596
Oklahoma,M04,2008,2.9,50232,1679666,1729898
Oklahoma,M03,2008,3.3,56234,1665279,1721513
Oklahoma,M02,2008,3.5,60405,1651223,1711628
Oklahoma,M01,2008,3.8,64955,1649761,1714716
Oklahoma,M12,2007,3.6,61539,1660322,1721861
Oklahoma,M11,2007,3.6,63196,1677234,1740430
Oklahoma,M10,2007,3.8,66072,1665493,1731565
Oklahoma,M09,2007,3.9,67185,1659639,1726824
Oklahoma,M08,2007,3.9,66966,1655523,1722489
Oklahoma,M07,2007,4.2,73866,1668063,1741929
Oklahoma,M06,2007,4.6,80024,1670559,1750583
Oklahoma,M05,2007,4.3,73818,1648427,1722245
Oklahoma,M04,2007,3.9,67540,1649129,1716669
Oklahoma,M03,2007,4.2,72295,1648496,1720791
Oklahoma,M02,2007,4.6,78766,1632226,1710992
Oklahoma,M01,2007,4.6,77963,1630769,1708732
Oklahoma,M12,2006,4.0,68323,1656800,1725123
Oklahoma,M11,2006,3.9,68310,1662627,1730937
Oklahoma,M10,2006,3.9,66742,1660187,1726929
Oklahoma,M09,2006,3.9,66383,1648376,1714759
Oklahoma,M08,2006,3.9,67596,1651993,1719589
Oklahoma,M07,2006,4.0,68425,1659613,1728038
Oklahoma,M06,2006,4.3,74332,1663589,1737921
Oklahoma,M05,2006,4.0,69087,1641588,1710675
Oklahoma,M04,2006,3.7,62271,1641308,1703579
Oklahoma,M03,2006,4.0,68204,1635459,1703663
Oklahoma,M02,2006,4.3,72331,1623218,1695549
Oklahoma,M01,2006,4.3,72352,1620415,1692767
Oklahoma,M12,2005,4.1,69859,1640087,1709946
Oklahoma,M11,2005,4.0,68088,1649498,1717586
Oklahoma,M10,2005,4.0,69238,1648966,1718204
Oklahoma,M09,2005,4.0,68982,1635655,1704637
Oklahoma,M08,2005,4.4,75974,1634756,1710730
Oklahoma,M07,2005,4.5,77389,1640869,1718258
Oklahoma,M06,2005,5.0,86696,1638459,1725155
Oklahoma,M05,2005,4.6,77431,1621184,1698615
Oklahoma,M04,2005,4.2,70823,1621600,1692423
Oklahoma,M03,2005,4.7,79571,1606634,1686205
Oklahoma,M02,2005,5.0,84527,1595313,1679840
Oklahoma,M01,2005,5.1,85618,1592303,1677921
Oklahoma,M12,2004,4.5,75972,1614308,1690280
Oklahoma,M11,2004,4.6,78253,1625797,1704050
Oklahoma,M10,2004,4.7,79069,1620798,1699867
Oklahoma,M09,2004,4.5,75283,1610045,1685328
Oklahoma,M08,2004,4.4,74644,1614410,1689054
Oklahoma,M07,2004,4.7,79967,1625798,1705765
Oklahoma,M06,2004,5.4,92574,1621227,1713801
Oklahoma,M05,2004,4.9,81787,1601844,1683631
Oklahoma,M04,2004,4.6,76731,1602836,1679567
Oklahoma,M03,2004,5.2,86542,1591421,1677963
Oklahoma,M02,2004,5.4,90573,1582138,1672711
Oklahoma,M01,2004,5.7,94847,1578431,1673278
Oklahoma,M12,2003,5.1,85068,1593686,1678754
Oklahoma,M11,2003,5.2,87704,1604507,1692211
Oklahoma,M10,2003,5.3,88977,1599594,1688571
Oklahoma,M09,2003,5.3,89173,1589144,1678317
Oklahoma,M08,2003,5.4,90178,1592215,1682393
Oklahoma,M07,2003,5.6,94760,1602801,1697561
Oklahoma,M06,2003,6.2,106024,1608047,1714071
Oklahoma,M05,2003,5.7,96427,1591599,1688026
Oklahoma,M04,2003,5.1,85122,1595797,1680919
Oklahoma,M03,2003,5.4,90508,1586849,1677357
Oklahoma,M02,2003,5.7,95187,1579844,1675031
Oklahoma,M01,2003,5.7,95481,1578167,1673648
Oklahoma,M12,2002,5.0,84538,1596724,1681262
Oklahoma,M11,2002,4.7,80062,1606839,1686901
Oklahoma,M10,2002,4.6,78188,1611575,1689763
Oklahoma,M09,2002,4.4,74543,1609206,1683749
Oklahoma,M08,2002,4.4,74020,1608706,1682726
Oklahoma,M07,2002,4.5,75673,1618964,1694637
Oklahoma,M06,2002,4.8,81526,1624836,1706362
Oklahoma,M05,2002,4.6,77422,1613455,1690877
Oklahoma,M04,2002,4.4,73433,1612478,1685911
Oklahoma,M03,2002,4.6,78060,1607601,1685661
Oklahoma,M02,2002,4.8,81493,1600331,1681824
Oklahoma,M01,2002,4.9,82585,1586558,1669143
Oklahoma,M12,2001,4.4,74070,1613117,1687187
Oklahoma,M11,2001,4.3,72193,1620834,1693027
Oklahoma,M10,2001,4.2,70425,1617258,1687683
Oklahoma,M09,2001,3.8,63447,1612527,1675974
Oklahoma,M08,2001,3.8,63076,1607116,1670192
Oklahoma,M07,2001,3.6,60518,1628540,1689058
Oklahoma,M06,2001,3.9,65576,1629938,1695514
Oklahoma,M05,2001,3.2,52609,1613846,1666455
Oklahoma,M04,2001,2.8,46608,1616761,1663369
Oklahoma,M03,2001,3.4,57287,1614038,1671325
Oklahoma,M02,2001,3.5,57837,1601366,1659203
Oklahoma,M01,2001,3.2,52704,1599524,1652228
Oklahoma,M12,2000,2.6,43807,1618481,1662288
Oklahoma,M11,2000,2.8,46322,1623635,1669957
Oklahoma,M10,2000,2.9,47698,1617950,1665648
Oklahoma,M09,2000,2.9,47682,1607627,1655309
Oklahoma,M08,2000,3.0,49899,1609072,1658971
Oklahoma,M07,2000,3.0,50672,1619920,1670592
Oklahoma,M06,2000,3.4,57311,1626413,1683724
Oklahoma,M05,2000,3.1,51249,1603521,1654770
Oklahoma,M04,2000,2.6,43009,1612322,1655331
Oklahoma,M03,2000,3.2,52736,1601867,1654603
Oklahoma,M02,2000,3.5,57321,1590766,1648087
Oklahoma,M01,2000,3.5,57436,1589616,1647052
Pennsylvania,M12,2016,4.8,306757,6088963,6395720
Pennsylvania,M11,2016,4.9,312670,6127195,6439865
Pennsylvania,M10,2016,5.2,339080,6122494,6461574
Pennsylvania,M09,2016,5.3,345629,6129267,6474896
Pennsylvania,M08,2016,5.9,381313,6128090,6509403
Pennsylvania,M07,2016,6.0,395273,6176968,6572241
Pennsylvania,M06,2016,5.7,370348,6150960,6521308
Pennsylvania,M05,2016,5.3,343548,6141429,6484977
Pennsylvania,M04,2016,5.2,334738,6124645,6459383
Pennsylvania,M03,2016,5.7,369891,6104818,6474709
Pennsylvania,M02,2016,5.6,361565,6082788,6444353
Pennsylvania,M01,2016,5.6,362723,6062725,6425448
Pennsylvania,M12,2015,4.7,297838,6099783,6397621
Pennsylvania,M11,2015,4.7,303387,6106545,6409932
Pennsylvania,M10,2015,4.8,305798,6097041,6402839
Pennsylvania,M09,2015,4.8,309495,6090900,6400395
Pennsylvania,M08,2015,5.4,350589,6108560,6459149
Pennsylvania,M07,2015,5.9,384320,6142114,6526434
Pennsylvania,M06,2015,5.6,361211,6136803,6498014
Pennsylvania,M05,2015,5.5,355027,6117629,6472656
Pennsylvania,M04,2015,4.9,313275,6079930,6393205
Pennsylvania,M03,2015,5.6,355079,6021341,6376420
Pennsylvania,M02,2015,5.7,365727,6011721,6377448
Pennsylvania,M01,2015,6.0,385013,6011579,6396592
Pennsylvania,M12,2014,4.8,307475,6055870,6363345
Pennsylvania,M11,2014,4.9,314365,6077155,6391520
Pennsylvania,M10,2014,5.0,321086,6079312,6400398
Pennsylvania,M09,2014,5.1,328446,6050754,6379200
Pennsylvania,M08,2014,6.1,390239,6039968,6430207
Pennsylvania,M07,2014,6.5,421989,6075768,6497757
Pennsylvania,M06,2014,6.0,385210,6068381,6453591
Pennsylvania,M05,2014,5.9,380713,6033521,6414234
Pennsylvania,M04,2014,5.4,343896,6005110,6349006
Pennsylvania,M03,2014,6.6,420954,5964373,6385327
Pennsylvania,M02,2014,6.8,432660,5926041,6358701
Pennsylvania,M01,2014,6.9,437750,5929199,6366949
Pennsylvania,M12,2013,6.1,386338,5962344,6348682
Pennsylvania,M11,2013,6.4,406880,5978901,6385781
Pennsylvania,M10,2013,6.8,433128,5946012,6379140
Pennsylvania,M09,2013,6.8,437360,5993490,6430850
Pennsylvania,M08,2013,7.5,486259,5998220,6484479
Pennsylvania,M07,2013,7.8,513419,6035475,6548894
Pennsylvania,M06,2013,7.7,504945,6019787,6524732
Pennsylvania,M05,2013,7.3,472231,6002057,6474288
Pennsylvania,M04,2013,7.0,448643,5965484,6414127
Pennsylvania,M03,2013,7.7,496360,5915917,6412277
Pennsylvania,M02,2013,8.2,527347,5904363,6431710
Pennsylvania,M01,2013,8.8,570081,5898035,6468116
Pennsylvania,M12,2012,7.6,487632,5968884,6456516
Pennsylvania,M11,2012,7.1,461881,5999701,6461582
Pennsylvania,M10,2012,7.5,485077,6003365,6488442
Pennsylvania,M09,2012,7.4,481251,5998001,6479252
Pennsylvania,M08,2012,8.3,541896,5968197,6510093
Pennsylvania,M07,2012,8.6,565474,6006298,6571772
Pennsylvania,M06,2012,8.2,539369,5999761,6539130
Pennsylvania,M05,2012,7.7,496827,5976587,6473414
Pennsylvania,M04,2012,7.1,451767,5943058,6394825
Pennsylvania,M03,2012,7.9,503058,5903667,6406725
Pennsylvania,M02,2012,8.2,521333,5868269,6389602
Pennsylvania,M01,2012,8.3,531932,5851976,6383908
Pennsylvania,M12,2011,7.4,471664,5929998,6401662
Pennsylvania,M11,2011,7.3,470095,5938831,6408926
Pennsylvania,M10,2011,7.5,480256,5921150,6401406
Pennsylvania,M09,2011,7.7,495586,5916216,6411802
Pennsylvania,M08,2011,8.3,538225,5907719,6445944
Pennsylvania,M07,2011,8.5,551111,5925971,6477082
Pennsylvania,M06,2011,8.4,539325,5912588,6451913
Pennsylvania,M05,2011,7.7,494909,5897056,6391965
Pennsylvania,M04,2011,7.3,460029,5882233,6342262
Pennsylvania,M03,2011,8.0,504851,5835038,6339889
Pennsylvania,M02,2011,8.3,527221,5799115,6326336
Pennsylvania,M01,2011,8.6,547854,5799021,6346875
Pennsylvania,M12,2010,7.7,487125,5864601,6351726
Pennsylvania,M11,2010,7.9,500299,5869404,6369703
Pennsylvania,M10,2010,7.6,484808,5870711,6355519
Pennsylvania,M09,2010,7.7,490746,5882232,6372978
Pennsylvania,M08,2010,8.5,545343,5899030,6444373
Pennsylvania,M07,2010,8.7,563537,5916404,6479941
Pennsylvania,M06,2010,8.6,551616,5884267,6435883
Pennsylvania,M05,2010,8.6,548349,5859925,6408274
Pennsylvania,M04,2010,8.3,526316,5845946,6372262
Pennsylvania,M03,2010,9.2,579804,5755122,6334926
Pennsylvania,M02,2010,9.5,602967,5715749,6318716
Pennsylvania,M01,2010,9.5,599838,5727248,6327086
Pennsylvania,M12,2009,8.1,508640,5783671,6292311
Pennsylvania,M11,2009,7.8,494767,5837970,6332737
Pennsylvania,M10,2009,7.9,499083,5833481,6332564
Pennsylvania,M09,2009,7.9,501782,5846469,6348251
Pennsylvania,M08,2009,8.4,540110,5897777,6437887
Pennsylvania,M07,2009,8.5,554104,5955192,6509296
Pennsylvania,M06,2009,8.4,543979,5932788,6476767
Pennsylvania,M05,2009,8.0,515247,5906486,6421733
Pennsylvania,M04,2009,7.4,470071,5916177,6386248
Pennsylvania,M03,2009,8.2,522329,5879202,6401531
Pennsylvania,M02,2009,8.2,527957,5899005,6426962
Pennsylvania,M01,2009,7.8,500880,5935988,6436868
Pennsylvania,M12,2008,6.3,404608,6058326,6462934
Pennsylvania,M11,2008,5.7,367513,6107783,6475296
Pennsylvania,M10,2008,5.3,342190,6139750,6481940
Pennsylvania,M09,2008,5.0,325151,6140232,6465383
Pennsylvania,M08,2008,5.6,363981,6162559,6526540
Pennsylvania,M07,2008,5.5,361251,6201220,6562471
Pennsylvania,M06,2008,5.3,343216,6168419,6511635
Pennsylvania,M05,2008,4.9,316582,6121491,6438073
Pennsylvania,M04,2008,4.4,279057,6108897,6387954
Pennsylvania,M03,2008,5.1,323040,6049109,6372149
Pennsylvania,M02,2008,5.3,334684,6020083,6354767
Pennsylvania,M01,2008,5.4,341412,6037870,6379282
Pennsylvania,M12,2007,4.4,282494,6094387,6376881
Pennsylvania,M11,2007,4.1,263742,6121244,6384986
Pennsylvania,M10,2007,4.1,259906,6092117,6352023
Pennsylvania,M09,2007,4.1,261481,6093797,6355278
Pennsylvania,M08,2007,4.5,288538,6104834,6393372
Pennsylvania,M07,2007,4.7,302387,6149041,6451428
Pennsylvania,M06,2007,4.5,290310,6111010,6401320
Pennsylvania,M05,2007,4.2,262365,6044743,6307108
Pennsylvania,M04,2007,3.9,242619,6017110,6259729
Pennsylvania,M03,2007,4.4,275314,6005680,6280994
Pennsylvania,M02,2007,4.8,300798,5960458,6261256
Pennsylvania,M01,2007,5.0,317252,5974340,6291592
Pennsylvania,M12,2006,4.0,252842,6066535,6319377
Pennsylvania,M11,2006,4.2,263033,6062164,6325197
Pennsylvania,M10,2006,3.9,244384,6059272,6303656
Pennsylvania,M09,2006,4.1,260914,6032339,6293253
Pennsylvania,M08,2006,4.8,303485,6060133,6363618
Pennsylvania,M07,2006,5.0,319736,6079121,6398857
Pennsylvania,M06,2006,4.9,308225,6045792,6354017
Pennsylvania,M05,2006,4.6,288027,5988390,6276417
Pennsylvania,M04,2006,4.4,272222,5965760,6237982
Pennsylvania,M03,2006,4.8,299648,5930388,6230036
Pennsylvania,M02,2006,5.2,320407,5896698,6217105
Pennsylvania,M01,2006,5.2,321512,5893016,6214528
Pennsylvania,M12,2005,4.4,274461,5964007,6238468
Pennsylvania,M11,2005,4.7,291281,5971038,6262319
Pennsylvania,M10,2005,4.4,273418,5982002,6255420
Pennsylvania,M09,2005,4.5,282305,5968335,6250640
Pennsylvania,M08,2005,4.8,302780,6012730,6315510
Pennsylvania,M07,2005,5.1,324832,6034580,6359412
Pennsylvania,M06,2005,5.1,323416,5980596,6304012
Pennsylvania,M05,2005,4.9,302882,5938018,6240900
Pennsylvania,M04,2005,4.7,290199,5914942,6205141
Pennsylvania,M03,2005,5.6,347136,5855312,6202448
Pennsylvania,M02,2005,5.8,361808,5830929,6192737
Pennsylvania,M01,2005,5.7,355464,5834345,6189809
Pennsylvania,M12,2004,4.9,306196,5918716,6224912
Pennsylvania,M11,2004,5.0,312158,5930109,6242267
Pennsylvania,M10,2004,4.9,307890,5918434,6226324
Pennsylvania,M09,2004,4.9,302696,5898234,6200930
Pennsylvania,M08,2004,5.4,336067,5937088,6273155
Pennsylvania,M07,2004,5.6,357020,5965840,6322860
Pennsylvania,M06,2004,5.7,358495,5911990,6270485
Pennsylvania,M05,2004,5.3,327680,5855336,6183016
Pennsylvania,M04,2004,5.1,311951,5837733,6149684
Pennsylvania,M03,2004,6.0,367543,5797166,6164709
Pennsylvania,M02,2004,6.0,371469,5775251,6146720
Pennsylvania,M01,2004,6.2,382203,5778071,6160274
Pennsylvania,M12,2003,5.0,306795,5850662,6157457
Pennsylvania,M11,2003,5.2,321671,5855125,6176796
Pennsylvania,M10,2003,5.1,313591,5847420,6161011
Pennsylvania,M09,2003,5.1,315192,5824321,6139513
Pennsylvania,M08,2003,5.5,339826,5861691,6201517
Pennsylvania,M07,2003,5.8,363248,5880523,6243771
Pennsylvania,M06,2003,6.0,372626,5862182,6234808
Pennsylvania,M05,2003,5.6,342331,5809342,6151673
Pennsylvania,M04,2003,5.5,334415,5798779,6133194
Pennsylvania,M03,2003,6.1,373742,5765909,6139651
Pennsylvania,M02,2003,6.5,396881,5747015,6143896
Pennsylvania,M01,2003,6.5,403456,5757566,6161022
Pennsylvania,M12,2002,5.6,346077,5832437,6178514
Pennsylvania,M11,2002,5.5,340833,5849179,6190012
Pennsylvania,M10,2002,5.1,316571,5887418,6203989
Pennsylvania,M09,2002,5.0,309624,5906412,6216036
Pennsylvania,M08,2002,5.4,341789,5930187,6271976
Pennsylvania,M07,2002,5.7,361314,5949014,6310328
Pennsylvania,M06,2002,5.8,364230,5923336,6287566
Pennsylvania,M05,2002,5.5,342509,5878586,6221095
Pennsylvania,M04,2002,5.4,334859,5852296,6187155
Pennsylvania,M03,2002,6.0,370940,5825361,6196301
Pennsylvania,M02,2002,6.2,382270,5811452,6193722
Pennsylvania,M01,2002,6.3,389412,5777611,6167023
Pennsylvania,M12,2001,5.0,311767,5870271,6182038
Pennsylvania,M11,2001,5.1,313414,5869440,6182854
Pennsylvania,M10,2001,4.8,295203,5881324,6176527
Pennsylvania,M09,2001,4.5,279953,5884285,6164238
Pennsylvania,M08,2001,4.9,306938,5909920,6216858
Pennsylvania,M07,2001,4.9,307155,5964124,6271279
Pennsylvania,M06,2001,4.9,306634,5926758,6233392
Pennsylvania,M05,2001,4.5,276146,5879664,6155810
Pennsylvania,M04,2001,4.2,257094,5871199,6128293
Pennsylvania,M03,2001,4.8,297390,5863127,6160517
Pennsylvania,M02,2001,5.0,305912,5832641,6138553
Pennsylvania,M01,2001,5.0,305541,5827508,6133049
Pennsylvania,M12,2000,3.8,235081,5895481,6130562
Pennsylvania,M11,2000,4.0,245774,5872858,6118632
Pennsylvania,M10,2000,3.8,230644,5865180,6095824
Pennsylvania,M09,2000,3.8,232035,5857849,6089884
Pennsylvania,M08,2000,4.2,260652,5900471,6161123
Pennsylvania,M07,2000,4.3,267272,5927834,6195106
Pennsylvania,M06,2000,4.3,262955,5906299,6169254
Pennsylvania,M05,2000,4.0,244364,5839755,6084119
Pennsylvania,M04,2000,3.6,217768,5843045,6060813
Pennsylvania,M03,2000,4.4,264019,5805366,6069385
Pennsylvania,M02,2000,4.7,284115,5772140,6056255
Pennsylvania,M01,2000,4.7,283411,5768335,6051746
Colorado,M12,2016,2.7,78247,2813948,2892195
Colorado,M11,2016,2.7,78408,2820857,2899265
Colorado,M10,2016,2.8,82055,2832967,2915022
Colorado,M09,2016,2.9,84799,2826325,2911124
Colorado,M08,2016,3.2,93703,2816841,2910544
Colorado,M07,2016,3.4,98970,2817091,2916061
Colorado,M06,2016,3.7,107876,2802971,2910847
Colorado,M05,2016,3.3,93353,2778528,2871881
Colorado,M04,2016,3.5,101832,2770129,2871961
Colorado,M03,2016,3.9,111638,2762407,2874045
Colorado,M02,2016,3.9,110856,2759890,2870746
Colorado,M01,2016,3.8,108016,2740846,2848862
Colorado,M12,2015,3.5,98229,2746767,2844996
Colorado,M11,2015,3.4,95464,2742669,2838133
Colorado,M10,2015,3.3,92909,2752087,2844996
Colorado,M09,2015,3.2,91016,2744937,2835953
Colorado,M08,2015,3.5,100788,2742402,2843190
Colorado,M07,2015,3.8,109764,2742881,2852645
Colorado,M06,2015,4.2,118941,2735571,2854512
Colorado,M05,2015,4.0,113241,2715619,2828860
Colorado,M04,2015,4.0,113907,2703339,2817246
Colorado,M03,2015,4.6,128812,2685890,2814702
Colorado,M02,2015,4.7,131216,2687565,2818781
Colorado,M01,2015,4.7,131996,2676096,2808092
Colorado,M12,2014,4.1,116212,2692379,2808591
Colorado,M11,2014,4.1,116124,2699030,2815154
Colorado,M10,2014,4.0,113630,2717875,2831505
Colorado,M09,2014,4.1,114502,2707808,2822310
Colorado,M08,2014,4.6,129702,2697525,2827227
Colorado,M07,2014,4.8,136404,2698450,2834854
Colorado,M06,2014,5.1,143853,2687224,2831077
Colorado,M05,2014,5.0,139195,2657146,2796341
Colorado,M04,2014,5.5,154158,2643876,2798034
Colorado,M03,2014,6.1,169516,2627003,2796519
Colorado,M02,2014,6.3,176924,2614441,2791365
Colorado,M01,2014,6.3,175337,2596666,2772003
Colorado,M12,2013,5.9,163189,2604318,2767507
Colorado,M11,2013,6.0,166869,2604039,2770908
Colorado,M10,2013,6.1,169181,2605159,2774340
Colorado,M09,2013,6.1,171138,2617705,2788843
Colorado,M08,2013,6.5,181622,2608849,2790471
Colorado,M07,2013,6.8,191479,2611117,2802596
Colorado,M06,2013,7.3,205407,2600200,2805607
Colorado,M05,2013,6.9,190568,2577105,2767673
Colorado,M04,2013,7.0,193725,2567055,2760780
Colorado,M03,2013,7.5,207624,2550281,2757905
Colorado,M02,2013,7.8,216607,2550264,2766871
Colorado,M01,2013,8.0,219059,2535474,2754533
Colorado,M12,2012,7.3,202882,2558399,2761281
Colorado,M11,2012,7.3,200982,2559651,2760633
Colorado,M10,2012,7.2,201531,2580320,2781851
Colorado,M09,2012,7.2,200813,2570666,2771479
Colorado,M08,2012,7.7,213516,2553378,2766894
Colorado,M07,2012,7.8,217440,2555233,2772673
Colorado,M06,2012,8.3,229598,2547214,2776812
Colorado,M05,2012,7.9,215284,2525760,2741044
Colorado,M04,2012,8.0,219708,2516875,2736583
Colorado,M03,2012,8.5,234466,2508245,2742711
Colorado,M02,2012,8.7,237694,2507400,2745094
Colorado,M01,2012,8.6,233462,2496154,2729616
Colorado,M12,2011,8.1,222259,2527850,2750109
Colorado,M11,2011,8.0,220558,2532447,2753005
Colorado,M10,2011,7.8,216581,2544730,2761311
Colorado,M09,2011,7.9,218432,2538934,2757366
Colorado,M08,2011,8.1,222795,2530105,2752900
Colorado,M07,2011,8.1,221884,2522266,2744150
Colorado,M06,2011,8.3,227272,2512680,2739952
Colorado,M05,2011,8.4,228940,2492678,2721618
Colorado,M04,2011,8.4,226851,2487321,2714172
Colorado,M03,2011,8.9,242514,2474629,2717143
Colorado,M02,2011,9.1,247618,2466352,2713970
Colorado,M01,2011,9.2,250069,2457186,2707255
Colorado,M12,2010,8.8,240169,2479608,2719777
Colorado,M11,2010,8.9,241314,2480684,2721998
Colorado,M10,2010,8.4,230527,2500142,2730669
Colorado,M09,2010,8.4,230473,2506449,2736922
Colorado,M08,2010,8.6,236200,2507247,2743447
Colorado,M07,2010,8.8,240357,2504406,2744763
Colorado,M06,2010,8.9,244606,2499160,2743766
Colorado,M05,2010,8.5,231059,2482338,2713397
Colorado,M04,2010,8.5,232113,2488655,2720768
Colorado,M03,2010,9.1,247339,2463694,2711033
Colorado,M02,2010,8.9,241842,2465586,2707428
Colorado,M01,2010,8.9,240159,2458883,2699042
Colorado,M12,2009,8.0,216554,2477274,2693828
Colorado,M11,2009,7.7,207644,2501137,2708781
Colorado,M10,2009,7.4,201590,2517635,2719225
Colorado,M09,2009,7.3,199250,2523054,2722304
Colorado,M08,2009,7.4,202846,2537989,2740835
Colorado,M07,2009,7.5,207672,2549151,2756823
Colorado,M06,2009,7.7,211371,2544955,2756326
Colorado,M05,2009,7.0,191469,2528583,2720052
Colorado,M04,2009,6.8,185081,2534524,2719605
Colorado,M03,2009,7.1,192220,2519114,2711334
Colorado,M02,2009,6.9,187630,2529827,2717457
Colorado,M01,2009,6.6,179146,2530075,2709221
Colorado,M12,2008,5.6,153339,2564627,2717966
Colorado,M11,2008,5.3,144918,2578791,2723709
Colorado,M10,2008,5.0,138222,2603537,2741759
Colorado,M09,2008,4.9,132802,2598101,2730903
Colorado,M08,2008,4.9,133939,2600596,2734535
Colorado,M07,2008,5.0,136285,2611184,2747469
Colorado,M06,2008,4.9,134852,2602788,2737640
Colorado,M05,2008,4.3,117290,2579494,2696784
Colorado,M04,2008,4.2,112894,2583265,2696159
Colorado,M03,2008,4.6,124379,2568025,2692404
Colorado,M02,2008,4.6,123037,2566514,2689551
Colorado,M01,2008,4.6,124627,2565998,2690625
Colorado,M12,2007,4.0,106291,2581945,2688236
Colorado,M11,2007,3.8,102022,2593328,2695350
Colorado,M10,2007,3.5,93972,2600049,2694021
Colorado,M09,2007,3.5,94629,2598434,2693063
Colorado,M08,2007,3.6,96489,2587367,2683856
Colorado,M07,2007,3.7,100942,2592615,2693557
Colorado,M06,2007,3.8,102732,2578276,2681008
Colorado,M05,2007,3.3,87361,2546845,2634206
Colorado,M04,2007,3.4,88949,2537886,2626835
Colorado,M03,2007,3.8,101056,2528954,2630010
Colorado,M02,2007,4.1,107077,2520827,2627904
Colorado,M01,2007,4.3,111984,2516090,2628074
Colorado,M12,2006,3.7,97124,2546864,2643988
Colorado,M11,2006,3.8,100959,2543910,2644869
Colorado,M10,2006,3.6,95699,2558536,2654235
Colorado,M09,2006,3.9,101960,2540275,2642235
Colorado,M08,2006,4.2,110204,2538784,2648988
Colorado,M07,2006,4.4,117878,2532393,2650271
Colorado,M06,2006,4.6,121906,2519950,2641856
Colorado,M05,2006,4.3,110885,2488971,2599856
Colorado,M04,2006,4.4,113139,2480354,2593493
Colorado,M03,2006,4.8,123882,2464201,2588083
Colorado,M02,2006,4.9,125893,2456876,2582769
Colorado,M01,2006,5.1,130636,2445638,2576274
Colorado,M12,2005,4.7,120283,2464903,2585186
Colorado,M11,2005,4.7,122187,2459354,2581541
Colorado,M10,2005,4.4,114175,2475293,2589468
Colorado,M09,2005,4.6,118063,2460109,2578172
Colorado,M08,2005,4.7,122086,2463445,2585531
Colorado,M07,2005,5.0,129311,2459253,2588564
Colorado,M06,2005,5.2,135356,2443917,2579273
Colorado,M05,2005,4.9,125222,2417498,2542720
Colorado,M04,2005,5.1,129596,2408115,2537711
Colorado,M03,2005,5.6,141485,2392249,2533734
Colorado,M02,2005,5.7,144504,2391916,2536420
Colorado,M01,2005,5.7,143549,2384932,2528481
Colorado,M12,2004,5.2,133306,2407603,2540909
Colorado,M11,2004,5.2,133247,2412816,2546063
Colorado,M10,2004,5.0,127493,2426518,2554011
Colorado,M09,2004,5.0,127596,2424954,2552550
Colorado,M08,2004,5.2,131855,2427138,2558993
Colorado,M07,2004,5.4,137773,2424658,2562431
Colorado,M06,2004,5.7,144198,2406275,2550473
Colorado,M05,2004,5.3,132112,2376972,2509084
Colorado,M04,2004,5.4,135439,2368096,2503535
Colorado,M03,2004,6.0,151282,2352040,2503322
Colorado,M02,2004,6.1,153085,2353244,2506329
Colorado,M01,2004,6.3,158242,2342399,2500641
Colorado,M12,2003,5.7,141521,2357507,2499028
Colorado,M11,2003,5.8,145302,2359566,2504868
Colorado,M10,2003,5.6,139909,2370733,2510642
Colorado,M09,2003,5.6,140887,2362794,2503681
Colorado,M08,2003,5.8,145868,2360821,2506689
Colorado,M07,2003,6.0,151630,2359246,2510876
Colorado,M06,2003,6.3,158654,2350159,2508813
Colorado,M05,2003,5.8,142214,2321070,2463284
Colorado,M04,2003,5.9,145529,2317695,2463224
Colorado,M03,2003,6.3,154933,2302151,2457084
Colorado,M02,2003,6.3,154117,2303381,2457498
Colorado,M01,2003,6.4,155703,2293365,2449068
Colorado,M12,2002,5.6,137195,2311391,2448586
Colorado,M11,2002,5.6,136101,2310368,2446469
Colorado,M10,2002,5.2,129459,2337517,2466976
Colorado,M09,2002,5.3,129751,2340207,2469958
Colorado,M08,2002,5.4,133192,2332835,2466027
Colorado,M07,2002,5.5,135827,2329382,2465209
Colorado,M06,2002,5.8,142041,2319062,2461103
Colorado,M05,2002,5.2,125672,2296716,2422388
Colorado,M04,2002,5.4,131661,2287162,2418823
Colorado,M03,2002,5.8,140883,2280287,2421170
Colorado,M02,2002,5.7,138789,2284322,2423111
Colorado,M01,2002,5.9,143109,2262965,2406074
Colorado,M12,2001,5.1,122739,2297695,2420434
Colorado,M11,2001,4.9,118779,2298628,2417407
Colorado,M10,2001,4.3,105209,2318290,2423499
Colorado,M09,2001,4.0,96713,2315858,2412571
Colorado,M08,2001,4.0,95461,2307085,2402546
Colorado,M07,2001,3.8,91170,2324231,2415401
Colorado,M06,2001,3.7,89448,2310432,2399880
Colorado,M05,2001,3.1,72401,2287544,2359945
Colorado,M04,2001,3.0,70399,2285809,2356208
Colorado,M03,2001,3.3,76950,2283273,2360223
Colorado,M02,2001,3.2,75290,2286450,2361740
Colorado,M01,2001,3.2,76661,2286063,2362724
Colorado,M12,2000,2.5,59926,2307764,2367690
Colorado,M11,2000,2.6,62403,2301554,2363957
Colorado,M10,2000,2.4,57053,2313383,2370436
Colorado,M09,2000,2.6,60406,2304338,2364744
Colorado,M08,2000,2.8,65254,2306307,2371561
Colorado,M07,2000,2.9,67813,2310073,2377886
Colorado,M06,2000,3.0,71098,2309304,2380402
Colorado,M05,2000,2.5,59072,2278169,2337241
Colorado,M04,2000,2.5,59760,2286739,2346499
Colorado,M03,2000,3.0,71050,2274419,2345469
Colorado,M02,2000,3.1,71931,2274887,2346818
Colorado,M01,2000,3.2,75513,2265954,2341467
Arizona,M12,2016,4.7,152384,3109029,3261413
Arizona,M11,2016,4.8,155867,3109640,3265507
Arizona,M10,2016,5.1,167206,3096802,3264008
Arizona,M09,2016,5.4,175080,3088027,3263107
Arizona,M08,2016,5.8,186548,3057135,3243683
Arizona,M07,2016,5.7,186236,3054038,3240274
Arizona,M06,2016,5.7,183455,3055749,3239204
Arizona,M05,2016,5.1,163739,3057063,3220802
Arizona,M04,2016,5.2,167967,3052150,3220117
Arizona,M03,2016,5.3,171025,3052289,3223314
Arizona,M02,2016,5.3,171147,3043812,3214959
Arizona,M01,2016,5.6,178545,3019432,3197977
Arizona,M12,2015,5.4,172789,3019906,3192695
Arizona,M11,2015,5.6,178770,3016366,3195136
Arizona,M10,2015,5.9,186750,3001274,3188024
Arizona,M09,2015,6.1,192588,2983805,3176393
Arizona,M08,2015,6.5,205564,2965342,3170906
Arizona,M07,2015,6.5,206319,2959916,3166235
Arizona,M06,2015,6.3,200488,2968912,3169400
Arizona,M05,2015,5.9,186624,2972365,3158989
Arizona,M04,2015,5.8,181351,2967150,3148501
Arizona,M03,2015,5.9,185229,2952541,3137770
Arizona,M02,2015,6.0,189411,2948363,3137774
Arizona,M01,2015,6.5,203876,2932881,3136757
Arizona,M12,2014,6.1,191549,2939162,3130711
Arizona,M11,2014,6.3,196962,2943172,3140134
Arizona,M10,2014,6.5,204531,2931043,3135574
Arizona,M09,2014,6.8,212741,2905984,3118725
Arizona,M08,2014,7.3,226068,2874095,3100163
Arizona,M07,2014,7.3,227380,2874123,3101503
Arizona,M06,2014,7.1,219834,2881094,3100928
Arizona,M05,2014,6.6,204455,2870276,3074731
Arizona,M04,2014,6.3,192544,2871477,3064021
Arizona,M03,2014,6.9,210809,2864938,3075747
Arizona,M02,2014,6.9,211424,2849262,3060686
Arizona,M01,2014,7.2,218357,2832057,3050414
Arizona,M12,2013,7.0,213499,2836503,3050002
Arizona,M11,2013,7.2,219701,2835047,3054748
Arizona,M10,2013,7.7,234151,2807227,3041378
Arizona,M09,2013,7.9,241125,2820283,3061408
Arizona,M08,2013,8.3,254184,2791809,3045993
Arizona,M07,2013,8.3,253152,2793476,3046628
Arizona,M06,2013,8.2,251554,2799653,3051207
Arizona,M05,2013,7.6,229166,2798554,3027720
Arizona,M04,2013,7.4,223349,2796582,3019931
Arizona,M03,2013,7.5,227177,2783755,3010932
Arizona,M02,2013,7.6,229128,2784468,3013596
Arizona,M01,2013,8.2,245892,2770766,3016658
Arizona,M12,2012,7.7,231963,2792963,3024926
Arizona,M11,2012,7.6,228714,2796543,3025257
Arizona,M10,2012,8.0,242487,2802293,3044780
Arizona,M09,2012,8.2,249483,2794236,3043719
Arizona,M08,2012,8.9,268240,2760976,3029216
Arizona,M07,2012,9.2,278251,2760372,3038623
Arizona,M06,2012,8.9,270045,2773931,3043976
Arizona,M05,2012,8.3,249605,2774610,3024215
Arizona,M04,2012,8.0,242088,2775048,3017136
Arizona,M03,2012,8.2,247868,2773382,3021250
Arizona,M02,2012,8.4,255111,2765636,3020747
Arizona,M01,2012,8.8,266493,2746202,3012695
Arizona,M12,2011,8.5,258710,2767372,3026082
Arizona,M11,2011,8.6,260006,2771520,3031526
Arizona,M10,2011,9.2,281277,2761627,3042904
Arizona,M09,2011,9.7,294074,2749981,3044055
Arizona,M08,2011,10.1,306952,2730578,3037530
Arizona,M07,2011,10.4,316488,2721077,3037565
Arizona,M06,2011,10.5,321949,2735012,3056961
Arizona,M05,2011,9.0,272704,2749559,3022263
Arizona,M04,2011,9.2,278280,2755651,3033931
Arizona,M03,2011,9.3,281253,2755519,3036772
Arizona,M02,2011,9.5,287934,2747262,3035196
Arizona,M01,2011,10.0,302938,2736477,3039415
Arizona,M12,2010,9.6,292729,2758177,3050906
Arizona,M11,2010,10.0,305994,2762786,3068780
Arizona,M10,2010,10.0,308121,2765261,3073382
Arizona,M09,2010,10.4,321367,2769823,3091190
Arizona,M08,2010,10.8,334974,2757981,3092955
Arizona,M07,2010,10.8,332603,2756102,3088705
Arizona,M06,2010,10.5,324108,2772243,3096351
Arizona,M05,2010,10.0,310530,2780676,3091206
Arizona,M04,2010,10.1,315212,2798099,3113311
Arizona,M03,2010,10.4,322451,2774614,3097065
Arizona,M02,2010,10.7,331045,2774348,3105393
Arizona,M01,2010,11.1,343882,2763335,3107217
Arizona,M12,2009,10.6,327651,2771215,3098866
Arizona,M11,2009,10.7,333907,2796062,3129969
Arizona,M10,2009,11.0,342755,2787217,3129972
Arizona,M09,2009,11.0,344927,2793248,3138175
Arizona,M08,2009,11.0,344704,2803128,3147832
Arizona,M07,2009,10.6,333040,2817280,3150320
Arizona,M06,2009,10.1,318563,2825981,3144544
Arizona,M05,2009,9.3,290147,2828954,3119101
Arizona,M04,2009,8.9,279248,2847499,3126747
Arizona,M03,2009,8.9,276839,2838171,3115010
Arizona,M02,2009,8.6,269450,2850786,3120236
Arizona,M01,2009,8.5,265168,2851388,3116556
Arizona,M12,2008,7.8,245014,2891026,3136040
Arizona,M11,2008,7.4,232414,2909898,3142312
Arizona,M10,2008,7.2,227681,2919164,3146845
Arizona,M09,2008,7.2,226257,2911623,3137880
Arizona,M08,2008,7.2,226000,2901941,3127941
Arizona,M07,2008,6.6,206931,2911106,3118037
Arizona,M06,2008,6.1,191462,2922000,3113462
Arizona,M05,2008,5.4,165262,2915179,3080441
Arizona,M04,2008,4.7,144983,2927601,3072584
Arizona,M03,2008,4.7,145028,2920500,3065528
Arizona,M02,2008,4.5,136914,2918561,3055475
Arizona,M01,2008,4.7,143570,2918237,3061807
Arizona,M12,2007,4.2,128842,2928811,3057653
Arizona,M11,2007,4.0,122313,2943481,3065794
Arizona,M10,2007,3.9,120280,2931187,3051467
Arizona,M09,2007,4.0,120639,2929813,3050452
Arizona,M08,2007,4.1,123561,2905900,3029461
Arizona,M07,2007,4.0,121726,2916634,3038360
Arizona,M06,2007,3.8,116406,2918505,3034911
Arizona,M05,2007,3.4,101041,2905154,3006195
Arizona,M04,2007,3.5,104770,2903843,3008613
Arizona,M03,2007,3.6,108628,2914052,3022680
Arizona,M02,2007,3.7,111686,2907332,3019018
Arizona,M01,2007,4.1,122898,2900697,3023595
Arizona,M12,2006,3.6,110093,2932134,3042227
Arizona,M11,2006,3.8,116017,2924084,3040101
Arizona,M10,2006,3.9,119324,2919301,3038625
Arizona,M09,2006,4.3,129631,2889398,3019029
Arizona,M08,2006,4.6,137621,2872643,3010264
Arizona,M07,2006,4.6,138910,2859746,2998656
Arizona,M06,2006,4.5,134598,2857877,2992475
Arizona,M05,2006,4.0,119619,2842521,2962140
Arizona,M04,2006,4.1,122207,2835831,2958038
Arizona,M03,2006,4.2,124208,2826930,2951138
Arizona,M02,2006,4.4,128577,2815585,2944162
Arizona,M01,2006,4.5,131872,2796570,2928442
Arizona,M12,2005,4.2,121636,2808118,2929754
Arizona,M11,2005,4.5,130761,2799267,2930028
Arizona,M10,2005,4.5,131986,2794213,2926199
Arizona,M09,2005,4.8,139507,2772904,2912411
Arizona,M08,2005,5.0,144363,2764240,2908603
Arizona,M07,2005,5.0,143566,2753108,2896674
Arizona,M06,2005,4.9,141748,2747345,2889093
Arizona,M05,2005,4.4,127329,2734086,2861415
Arizona,M04,2005,4.6,130791,2724613,2855404
Arizona,M03,2005,4.7,133637,2702663,2836300
Arizona,M02,2005,4.7,134289,2696523,2830812
Arizona,M01,2005,4.9,138629,2683378,2822007
Arizona,M12,2004,4.4,123763,2701847,2825610
Arizona,M11,2004,4.5,128512,2702135,2830647
Arizona,M10,2004,4.7,133633,2688693,2822326
Arizona,M09,2004,4.9,137822,2671378,2809200
Arizona,M08,2004,5.3,148564,2660603,2809167
Arizona,M07,2004,5.4,151881,2656076,2807957
Arizona,M06,2004,5.4,152130,2648461,2800591
Arizona,M05,2004,4.9,135762,2634856,2770618
Arizona,M04,2004,5.1,140951,2630899,2771850
Arizona,M03,2004,5.2,144266,2626678,2770944
Arizona,M02,2004,5.1,139986,2628984,2768970
Arizona,M01,2004,5.5,152827,2614525,2767352
Arizona,M12,2003,4.9,136322,2627323,2763645
Arizona,M11,2003,5.2,142563,2624589,2767152
Arizona,M10,2003,5.5,150758,2608972,2759730
Arizona,M09,2003,5.9,161000,2590628,2751628
Arizona,M08,2003,6.2,171352,2573338,2744690
Arizona,M07,2003,6.1,168224,2568060,2736284
Arizona,M06,2003,6.3,173220,2577974,2751194
Arizona,M05,2003,5.6,153001,2565158,2718159
Arizona,M04,2003,5.6,152559,2567218,2719777
Arizona,M03,2003,5.7,154611,2556265,2710876
Arizona,M02,2003,5.8,156224,2551711,2707935
Arizona,M01,2003,6.1,165923,2535011,2700934
Arizona,M12,2002,5.7,153937,2548049,2701986
Arizona,M11,2002,5.9,158503,2545097,2703600
Arizona,M10,2002,6.0,163567,2547617,2711184
Arizona,M09,2002,6.2,169101,2542802,2711903
Arizona,M08,2002,6.7,180738,2517556,2698294
Arizona,M07,2002,6.5,175775,2508385,2684160
Arizona,M06,2002,6.5,175161,2512787,2687948
Arizona,M05,2002,5.9,158254,2505969,2664223
Arizona,M04,2002,5.9,157205,2500877,2658082
Arizona,M03,2002,5.9,156449,2499367,2655816
Arizona,M02,2002,5.7,152336,2497626,2649962
Arizona,M01,2002,6.1,159950,2465945,2625895
Arizona,M12,2001,5.3,139257,2495064,2634321
Arizona,M11,2001,5.3,138119,2486056,2624175
Arizona,M10,2001,5.3,138188,2481616,2619804
Arizona,M09,2001,5.5,142930,2469210,2612140
Arizona,M08,2001,5.6,144425,2438638,2583063
Arizona,M07,2001,5.0,130486,2456565,2587051
Arizona,M06,2001,5.0,128020,2453519,2581539
Arizona,M05,2001,4.1,105634,2451591,2557225
Arizona,M04,2001,4.1,104576,2456139,2560715
Arizona,M03,2001,4.1,105944,2459004,2564948
Arizona,M02,2001,3.9,99146,2452493,2551639
Arizona,M01,2001,4.3,108704,2438079,2546783
Arizona,M12,2000,3.5,88374,2455539,2543913
Arizona,M11,2000,3.5,88392,2439410,2527802
Arizona,M10,2000,3.8,95167,2427984,2523151
Arizona,M09,2000,4.0,101478,2409529,2511007
Arizona,M08,2000,4.5,113626,2391290,2504916
Arizona,M07,2000,4.4,109829,2392192,2502021
Arizona,M06,2000,4.3,107543,2407989,2515532
Arizona,M05,2000,3.8,94604,2392726,2487330
Arizona,M04,2000,3.6,91043,2409399,2500442
Arizona,M03,2000,3.9,98117,2403978,2502095
Arizona,M02,2000,3.9,97464,2405352,2502816
Arizona,M01,2000,4.2,105985,2391578,2497563
Washington,M12,2016,5.3,193221,3473180,3666401
Washington,M11,2016,5.1,188004,3483125,3671129
Washington,M10,2016,5.0,184152,3497148,3681300
Washington,M09,2016,5.1,185885,3480568,3666453
Washington,M08,2016,5.3,193627,3465143,3658770
Washington,M07,2016,5.4,198745,3476514,3675259
Washington,M06,2016,5.4,196498,3459104,3655602
Washington,M05,2016,5.2,190151,3435080,3625231
Washington,M04,2016,5.3,190589,3422483,3613072
Washington,M03,2016,5.8,210755,3413673,3624428
Washington,M02,2016,6.1,221553,3386550,3608103
Washington,M01,2016,6.2,222835,3357993,3580828
Washington,M12,2015,5.8,208260,3367106,3575366
Washington,M11,2015,5.6,200738,3363184,3563922
Washington,M10,2015,5.3,188424,3374441,3562865
Washington,M09,2015,5.2,183876,3361815,3545691
Washington,M08,2015,5.4,190266,3357488,3547754
Washington,M07,2015,5.5,197936,3370755,3568691
Washington,M06,2015,5.4,192713,3365434,3558147
Washington,M05,2015,5.5,196518,3348891,3545409
Washington,M04,2015,5.2,183330,3337277,3520607
Washington,M03,2015,5.8,204282,3319822,3524104
Washington,M02,2015,6.3,223488,3300600,3524088
Washington,M01,2015,6.5,228208,3283205,3511413
Washington,M12,2014,5.9,208175,3302158,3510333
Washington,M11,2014,6.0,209473,3306193,3515666
Washington,M10,2014,5.6,197952,3324889,3522841
Washington,M09,2014,5.6,197212,3305169,3502381
Washington,M08,2014,6.0,209485,3293385,3502870
Washington,M07,2014,6.0,211625,3310559,3522184
Washington,M06,2014,5.8,202586,3290774,3493360
Washington,M05,2014,6.0,207359,3265440,3472799
Washington,M04,2014,5.7,197205,3255303,3452508
Washington,M03,2014,6.7,232799,3244212,3477011
Washington,M02,2014,7.2,248773,3218921,3467694
Washington,M01,2014,7.0,242220,3203473,3445693
Washington,M12,2013,6.6,228942,3221339,3450281
Washington,M11,2013,6.6,227403,3228844,3456247
Washington,M10,2013,6.5,226774,3237664,3464438
Washington,M09,2013,6.4,221450,3242510,3463960
Washington,M08,2013,6.8,234970,3232641,3467611
Washington,M07,2013,6.9,240878,3250647,3491525
Washington,M06,2013,7.0,244731,3239112,3483843
Washington,M05,2013,6.9,239574,3220358,3459932
Washington,M04,2013,6.8,234146,3212657,3446803
Washington,M03,2013,7.4,256960,3196156,3453116
Washington,M02,2013,8.1,278823,3178581,3457404
Washington,M01,2013,8.4,288920,3162341,3451261
Washington,M12,2012,7.6,260890,3190321,3451211
Washington,M11,2012,7.3,250641,3201719,3452360
Washington,M10,2012,7.2,249724,3229822,3479546
Washington,M09,2012,7.3,253201,3212686,3465887
Washington,M08,2012,7.9,274097,3192496,3466593
Washington,M07,2012,8.2,286256,3211726,3497982
Washington,M06,2012,8.2,286918,3208095,3495013
Washington,M05,2012,8.2,285613,3191681,3477294
Washington,M04,2012,8.0,277566,3182211,3459777
Washington,M03,2012,8.9,308147,3171282,3479429
Washington,M02,2012,9.4,326271,3149801,3476072
Washington,M01,2012,9.4,324812,3129408,3454220
Washington,M12,2011,8.8,304655,3148024,3452679
Washington,M11,2011,8.7,299338,3152477,3451815
Washington,M10,2011,8.6,297041,3170561,3467602
Washington,M09,2011,8.7,301575,3158253,3459828
Washington,M08,2011,9.0,311660,3153374,3465034
Washington,M07,2011,9.1,316851,3163150,3480001
Washington,M06,2011,9.4,325617,3148814,3474431
Washington,M05,2011,9.3,320667,3136766,3457433
Washington,M04,2011,9.1,314715,3132138,3446853
Washington,M03,2011,9.9,341199,3121076,3462275
Washington,M02,2011,10.4,359310,3101864,3461174
Washington,M01,2011,10.5,362227,3095780,3458007
Washington,M12,2010,9.6,333850,3132092,3465942
Washington,M11,2010,9.8,339836,3145218,3485054
Washington,M10,2010,9.1,319498,3177408,3496906
Washington,M09,2010,9.3,325488,3176215,3501703
Washington,M08,2010,9.6,337371,3177426,3514797
Washington,M07,2010,9.5,335591,3196074,3531665
Washington,M06,2010,9.8,344103,3183313,3527416
Washington,M05,2010,9.9,346766,3170459,3517225
Washington,M04,2010,10.0,351319,3173310,3524629
Washington,M03,2010,10.9,383888,3147472,3531360
Washington,M02,2010,11.2,395374,3127044,3522418
Washington,M01,2010,11.3,396296,3120494,3516790
Washington,M12,2009,10.5,369429,3148928,3518357
Washington,M11,2009,9.9,350402,3175204,3525606
Washington,M10,2009,9.7,345138,3204231,3549369
Washington,M09,2009,9.7,346390,3209163,3555553
Washington,M08,2009,9.6,342877,3222771,3565648
Washington,M07,2009,9.2,330670,3251174,3581844
Washington,M06,2009,9.2,326529,3234063,3560592
Washington,M05,2009,8.7,308090,3216695,3524785
Washington,M04,2009,8.3,289839,3223145,3512984
Washington,M03,2009,8.5,299096,3214721,3513817
Washington,M02,2009,8.5,298821,3218093,3516914
Washington,M01,2009,7.9,275336,3221599,3496935
Washington,M12,2008,6.6,231396,3270034,3501430
Washington,M11,2008,6.0,209061,3292276,3501337
Washington,M10,2008,5.4,189309,3320005,3509314
Washington,M09,2008,5.1,178117,3309585,3487702
Washington,M08,2008,5.4,188860,3309050,3497910
Washington,M07,2008,5.2,183553,3327647,3511200
Washington,M06,2008,5.2,181375,3307032,3488407
Washington,M05,2008,5.0,174180,3283780,3457960
Washington,M04,2008,4.7,160935,3285542,3446477
Washington,M03,2008,5.2,179880,3275568,3455448
Washington,M02,2008,5.5,188269,3257932,3446201
Washington,M01,2008,5.3,182284,3257256,3439540
Washington,M12,2007,4.8,165150,3274759,3439909
Washington,M11,2007,4.6,158285,3285378,3443663
Washington,M10,2007,4.2,143585,3293928,3437513
Washington,M09,2007,4.3,147847,3275387,3423234
Washington,M08,2007,4.5,153721,3261295,3415016
Washington,M07,2007,4.6,156811,3279160,3435971
Washington,M06,2007,4.5,154763,3260719,3415482
Washington,M05,2007,4.5,150730,3228462,3379192
Washington,M04,2007,4.5,149764,3214930,3364694
Washington,M03,2007,5.0,168358,3205755,3374113
Washington,M02,2007,5.5,183518,3177592,3361110
Washington,M01,2007,5.5,185732,3162335,3348067
Washington,M12,2006,4.9,164601,3193816,3358417
Washington,M11,2006,5.0,166208,3185116,3351324
Washington,M10,2006,4.4,146466,3202014,3348480
Washington,M09,2006,4.7,155441,3173545,3328986
Washington,M08,2006,5.0,166851,3170804,3337655
Washington,M07,2006,5.0,167522,3184287,3351809
Washington,M06,2006,5.0,167755,3168487,3336242
Washington,M05,2006,5.0,164979,3140919,3305898
Washington,M04,2006,4.8,158013,3134821,3292834
Washington,M03,2006,5.3,175481,3126786,3302267
Washington,M02,2006,5.8,190156,3104585,3294741
Washington,M01,2006,5.6,184272,3094327,3278599
Washington,M12,2005,5.1,168935,3115776,3284711
Washington,M11,2005,5.4,176702,3112268,3288970
Washington,M10,2005,4.9,162599,3134779,3297378
Washington,M09,2005,5.2,168854,3106157,3275011
Washington,M08,2005,5.3,174300,3111199,3285499
Washington,M07,2005,5.3,175816,3121688,3297504
Washington,M06,2005,5.5,179965,3095839,3275804
Washington,M05,2005,5.4,176960,3070754,3247714
Washington,M04,2005,5.5,177507,3057506,3235013
Washington,M03,2005,6.0,194626,3038427,3233053
Washington,M02,2005,6.6,212744,3016691,3229435
Washington,M01,2005,6.4,206640,3007706,3214346
Washington,M12,2004,5.9,190381,3036314,3226695
Washington,M11,2004,5.8,185875,3033095,3218970
Washington,M10,2004,5.4,172919,3044110,3217029
Washington,M09,2004,5.4,173593,3020211,3193804
Washington,M08,2004,5.8,186593,3019379,3205972
Washington,M07,2004,5.9,191306,3032956,3224262
Washington,M06,2004,6.2,199413,3009711,3209124
Washington,M05,2004,6.1,194546,2981354,3175900
Washington,M04,2004,6.3,198993,2973462,3172455
Washington,M03,2004,7.2,228140,2956699,3184839
Washington,M02,2004,7.5,238411,2936744,3175155
Washington,M01,2004,7.7,243426,2917505,3160931
Washington,M12,2003,7.0,220647,2939410,3160057
Washington,M11,2003,7.1,223986,2932800,3156786
Washington,M10,2003,6.6,208420,2942365,3150785
Washington,M09,2003,6.9,215396,2913263,3128659
Washington,M08,2003,7.3,227825,2907424,3135249
Washington,M07,2003,7.3,229202,2917617,3146819
Washington,M06,2003,7.6,239141,2898579,3137720
Washington,M05,2003,7.3,227516,2872343,3099859
Washington,M04,2003,7.5,231205,2870146,3101351
Washington,M03,2003,8.0,247667,2862025,3109692
Washington,M02,2003,8.2,255517,2851896,3107413
Washington,M01,2003,8.1,251969,2842493,3094462
Washington,M12,2002,7.4,227670,2864647,3092317
Washington,M11,2002,7.3,225272,2864037,3089309
Washington,M10,2002,6.6,204335,2902500,3106835
Washington,M09,2002,6.7,206321,2891976,3098297
Washington,M08,2002,7.1,218861,2880891,3099752
Washington,M07,2002,7.1,220745,2890808,3111553
Washington,M06,2002,7.3,226304,2866628,3092932
Washington,M05,2002,7.3,222650,2844108,3066758
Washington,M04,2002,7.6,233779,2829854,3063633
Washington,M03,2002,8.0,246766,2822633,3069399
Washington,M02,2002,8.2,250625,2814127,3064752
Washington,M01,2002,8.3,253601,2784937,3038538
Washington,M12,2001,7.3,221613,2822854,3044467
Washington,M11,2001,7.0,212388,2820913,3033301
Washington,M10,2001,6.1,186709,2851409,3038118
Washington,M09,2001,5.9,178912,2843804,3022716
Washington,M08,2001,6.2,188501,2837709,3026210
Washington,M07,2001,5.9,179783,2880336,3060119
Washington,M06,2001,6.1,184914,2861517,3046431
Washington,M05,2001,5.9,177690,2849125,3026815
Washington,M04,2001,5.9,178550,2850329,3028879
Washington,M03,2001,6.4,195905,2858408,3054313
Washington,M02,2001,6.6,200764,2848174,3048938
Washington,M01,2001,6.3,192178,2849921,3042099
Washington,M12,2000,5.3,160303,2883404,3043707
Washington,M11,2000,5.2,158871,2878371,3037242
Washington,M10,2000,4.6,140914,2906504,3047418
Washington,M09,2000,4.7,141916,2888440,3030356
Washington,M08,2000,5.2,158715,2899863,3058578
Washington,M07,2000,5.1,155901,2922080,3077981
Washington,M06,2000,5.0,153912,2924913,3078825
Washington,M05,2000,5.0,151672,2901298,3052970
Washington,M04,2000,4.8,146424,2913811,3060235
Washington,M03,2000,5.5,169206,2912153,3081359
Washington,M02,2000,5.9,181966,2895010,3076976
Washington,M01,2000,5.7,174360,2892052,3066412
South Dakota,M12,2016,3.1,13748,436952,450700
South Dakota,M11,2016,2.7,12215,441825,454040
South Dakota,M10,2016,2.4,11096,443886,454982
South Dakota,M09,2016,2.5,11406,439945,451351
South Dakota,M08,2016,2.7,12510,445669,458179
South Dakota,M07,2016,2.6,11911,450478,462389
South Dakota,M06,2016,2.8,12784,448718,461502
South Dakota,M05,2016,2.6,11951,441299,453250
South Dakota,M04,2016,2.7,12268,438315,450583
South Dakota,M03,2016,3.2,14162,435063,449225
South Dakota,M02,2016,3.3,14734,432251,446985
South Dakota,M01,2016,3.3,14459,429183,443642
South Dakota,M12,2015,2.9,13007,435762,448769
South Dakota,M11,2015,2.6,11943,438957,450900
South Dakota,M10,2015,2.4,10839,440431,451270
South Dakota,M09,2015,2.6,11498,436979,448477
South Dakota,M08,2015,2.8,12812,442326,455138
South Dakota,M07,2015,2.8,12917,446445,459362
South Dakota,M06,2015,3.0,13981,445516,459497
South Dakota,M05,2015,3.1,13983,438674,452657
South Dakota,M04,2015,3.2,14168,435269,449437
South Dakota,M03,2015,3.8,16836,431626,448462
South Dakota,M02,2015,3.8,17121,428452,445573
South Dakota,M01,2015,3.9,17152,425181,442333
South Dakota,M12,2014,3.5,15539,431176,446715
South Dakota,M11,2014,3.3,14729,434416,449145
South Dakota,M10,2014,2.8,12777,436723,449500
South Dakota,M09,2014,2.9,13093,433424,446517
South Dakota,M08,2014,3.1,14106,438545,452651
South Dakota,M07,2014,3.0,13739,442383,456122
South Dakota,M06,2014,3.2,14799,440919,455718
South Dakota,M05,2014,3.3,14717,434024,448741
South Dakota,M04,2014,3.6,15988,430035,446023
South Dakota,M03,2014,4.1,18264,426761,445025
South Dakota,M02,2014,4.2,18465,424226,442691
South Dakota,M01,2014,4.2,18314,421255,439569
South Dakota,M12,2013,3.6,16053,426605,442658
South Dakota,M11,2013,3.5,15499,430600,446099
South Dakota,M10,2013,3.3,14585,431513,446098
South Dakota,M09,2013,3.3,14820,428356,443176
South Dakota,M08,2013,3.5,15766,433636,449402
South Dakota,M07,2013,3.4,15465,437239,452704
South Dakota,M06,2013,3.6,16312,436212,452524
South Dakota,M05,2013,3.6,15976,429374,445350
South Dakota,M04,2013,4.0,17574,424104,441678
South Dakota,M03,2013,4.4,19376,422051,441427
South Dakota,M02,2013,4.6,20135,419116,439251
South Dakota,M01,2013,4.6,20040,416074,436114
South Dakota,M12,2012,4.1,17870,422213,440083
South Dakota,M11,2012,3.9,17344,426085,443429
South Dakota,M10,2012,3.7,16634,427386,444020
South Dakota,M09,2012,3.9,17004,423850,440854
South Dakota,M08,2012,4.1,18316,428552,446868
South Dakota,M07,2012,4.0,18254,432601,450855
South Dakota,M06,2012,4.2,19017,431678,450695
South Dakota,M05,2012,4.2,18491,424294,442785
South Dakota,M04,2012,4.3,18879,421542,440421
South Dakota,M03,2012,4.9,21601,417662,439263
South Dakota,M02,2012,5.0,22027,414339,436366
South Dakota,M01,2012,5.0,21855,411813,433668
South Dakota,M12,2011,4.5,19755,418645,438400
South Dakota,M11,2011,4.2,18410,422115,440525
South Dakota,M10,2011,3.9,17245,423952,441197
South Dakota,M09,2011,4.1,18081,420077,438158
South Dakota,M08,2011,4.4,19511,425874,445385
South Dakota,M07,2011,4.3,19436,429893,449329
South Dakota,M06,2011,4.6,20444,428034,448478
South Dakota,M05,2011,4.6,20444,420775,441219
South Dakota,M04,2011,4.9,21558,417674,439232
South Dakota,M03,2011,5.8,25307,413880,439187
South Dakota,M02,2011,5.8,25141,411283,436424
South Dakota,M01,2011,5.8,25228,408444,433672
South Dakota,M12,2010,5.1,22540,415633,438173
South Dakota,M11,2010,4.6,20369,420106,440475
South Dakota,M10,2010,4.3,19201,422490,441691
South Dakota,M09,2010,4.4,19278,418781,438059
South Dakota,M08,2010,4.7,20774,425484,446258
South Dakota,M07,2010,4.6,20494,429701,450195
South Dakota,M06,2010,4.7,21211,427889,449100
South Dakota,M05,2010,4.8,21243,420631,441874
South Dakota,M04,2010,4.9,21437,418174,439611
South Dakota,M03,2010,5.9,26079,413895,439974
South Dakota,M02,2010,5.9,25582,411062,436644
South Dakota,M01,2010,5.9,25597,408410,434007
South Dakota,M12,2009,5.3,23021,415434,438455
South Dakota,M11,2009,4.7,20791,421066,441857
South Dakota,M10,2009,4.5,19925,423474,443399
South Dakota,M09,2009,4.4,19614,421589,441203
South Dakota,M08,2009,4.7,21292,428359,449651
South Dakota,M07,2009,4.7,21485,434250,455735
South Dakota,M06,2009,4.9,22384,432644,455028
South Dakota,M05,2009,4.9,22153,426192,448345
South Dakota,M04,2009,5.2,23336,422802,446138
South Dakota,M03,2009,5.6,25011,421910,446921
South Dakota,M02,2009,5.2,23157,420983,444140
South Dakota,M01,2009,5.0,22029,419215,441244
South Dakota,M12,2008,3.9,17504,427155,444659
South Dakota,M11,2008,3.4,15369,431796,447165
South Dakota,M10,2008,3.0,13537,435239,448776
South Dakota,M09,2008,2.9,12976,432071,445047
South Dakota,M08,2008,3.0,13707,439253,452960
South Dakota,M07,2008,2.8,12979,443147,456126
South Dakota,M06,2008,2.8,12927,441552,454479
South Dakota,M05,2008,2.7,12185,434468,446653
South Dakota,M04,2008,2.8,12255,431451,443706
South Dakota,M03,2008,3.1,13676,429227,442903
South Dakota,M02,2008,3.1,13610,426538,440148
South Dakota,M01,2008,3.1,13586,423198,436784
South Dakota,M12,2007,2.7,11803,428122,439925
South Dakota,M11,2007,2.5,11043,432114,443157
South Dakota,M10,2007,2.4,10472,433810,444282
South Dakota,M09,2007,2.5,10942,430361,441303
South Dakota,M08,2007,2.6,11729,437417,449146
South Dakota,M07,2007,2.6,11680,441640,453320
South Dakota,M06,2007,2.7,12172,438970,451142
South Dakota,M05,2007,2.7,11873,431085,442958
South Dakota,M04,2007,2.9,12641,426911,439552
South Dakota,M03,2007,3.4,14728,423523,438251
South Dakota,M02,2007,3.5,15432,419927,435359
South Dakota,M01,2007,3.6,15344,416254,431598
South Dakota,M12,2006,3.1,13432,422333,435765
South Dakota,M11,2006,2.9,12880,425042,437922
South Dakota,M10,2006,2.8,12238,426296,438534
South Dakota,M09,2006,2.9,12435,422389,434824
South Dakota,M08,2006,3.0,13454,428961,442415
South Dakota,M07,2006,3.0,13140,432215,445355
South Dakota,M06,2006,3.0,13354,429918,443272
South Dakota,M05,2006,2.9,12575,421380,433955
South Dakota,M04,2006,2.9,12631,417324,429955
South Dakota,M03,2006,3.5,15011,413937,428948
South Dakota,M02,2006,3.6,15273,410796,426069
South Dakota,M01,2006,3.7,15865,407210,423075
South Dakota,M12,2005,3.5,15121,413159,428280
South Dakota,M11,2005,3.3,14027,416139,430166
South Dakota,M10,2005,3.2,13621,417667,431288
South Dakota,M09,2005,3.3,14333,414670,429003
South Dakota,M08,2005,3.6,15490,420796,436286
South Dakota,M07,2005,3.6,15924,424617,440541
South Dakota,M06,2005,3.8,16766,422187,438953
South Dakota,M05,2005,3.9,16796,414310,431106
South Dakota,M04,2005,3.9,16632,411906,428538
South Dakota,M03,2005,4.5,19298,407936,427234
South Dakota,M02,2005,4.6,19368,405062,424430
South Dakota,M01,2005,4.6,19391,402061,421452
South Dakota,M12,2004,3.9,16453,408570,425023
South Dakota,M11,2004,3.6,15458,412791,428249
South Dakota,M10,2004,3.4,14515,415180,429695
South Dakota,M09,2004,3.4,14584,411921,426505
South Dakota,M08,2004,3.6,15559,418128,433687
South Dakota,M07,2004,3.6,15543,421987,437530
South Dakota,M06,2004,3.7,15985,420579,436564
South Dakota,M05,2004,3.5,15135,413319,428454
South Dakota,M04,2004,3.5,14672,410265,424937
South Dakota,M03,2004,4.2,17988,405296,423284
South Dakota,M02,2004,4.1,17383,403013,420396
South Dakota,M01,2004,4.2,17545,400100,417645
South Dakota,M12,2003,3.7,15400,406141,421541
South Dakota,M11,2003,3.4,14632,409994,424626
South Dakota,M10,2003,3.1,13115,411543,424658
South Dakota,M09,2003,3.2,13640,407718,421358
South Dakota,M08,2003,3.4,14601,415124,429725
South Dakota,M07,2003,3.4,14690,418640,433330
South Dakota,M06,2003,3.5,14893,416280,431173
South Dakota,M05,2003,3.3,14138,408836,422974
South Dakota,M04,2003,3.4,14414,405434,419848
South Dakota,M03,2003,4.0,16751,401654,418405
South Dakota,M02,2003,4.0,16508,399203,415711
South Dakota,M01,2003,4.0,16578,396485,413063
South Dakota,M12,2002,3.2,13534,402917,416451
South Dakota,M11,2002,3.0,12749,406178,418927
South Dakota,M10,2002,2.7,11146,408879,420025
South Dakota,M09,2002,2.6,10947,405303,416250
South Dakota,M08,2002,2.9,12127,411770,423897
South Dakota,M07,2002,2.8,12097,415554,427651
South Dakota,M06,2002,2.9,12546,413228,425774
South Dakota,M05,2002,2.9,12079,405542,417621
South Dakota,M04,2002,3.3,13666,400894,414560
South Dakota,M03,2002,4.0,16527,396541,413068
South Dakota,M02,2002,3.9,15787,393958,409745
South Dakota,M01,2002,4.0,16136,390107,406243
South Dakota,M12,2001,3.5,14318,397064,411382
South Dakota,M11,2001,3.1,12840,400836,413676
South Dakota,M10,2001,2.9,12133,402587,414720
South Dakota,M09,2001,2.8,11687,399423,411110
South Dakota,M08,2001,3.0,12660,406202,418862
South Dakota,M07,2001,3.0,12560,410669,423229
South Dakota,M06,2001,3.0,12827,408814,421641
South Dakota,M05,2001,2.9,11791,401784,413575
South Dakota,M04,2001,3.0,12132,397763,409895
South Dakota,M03,2001,3.4,13958,394505,408463
South Dakota,M02,2001,3.3,13220,392003,405223
South Dakota,M01,2001,3.2,12838,388716,401554
South Dakota,M12,2000,2.6,10557,394209,404766
South Dakota,M11,2000,2.6,10426,397589,408015
South Dakota,M10,2000,2.0,8365,400394,408759
South Dakota,M09,2000,2.1,8331,397212,405543
South Dakota,M08,2000,2.3,9486,403557,413043
South Dakota,M07,2000,2.2,9348,408019,417367
South Dakota,M06,2000,2.4,9958,407450,417408
South Dakota,M05,2000,2.3,9397,400628,410025
South Dakota,M04,2000,2.2,9074,398581,407655
South Dakota,M03,2000,2.8,11409,395367,406776
South Dakota,M02,2000,2.9,11827,391807,403634
South Dakota,M01,2000,3.1,12305,388603,400908
Wyoming,M12,2016,5.0,14866,284248,299114
Wyoming,M11,2016,4.6,13967,286447,300414
Wyoming,M10,2016,4.5,13436,287543,300979
Wyoming,M09,2016,4.5,13574,287974,301548
Wyoming,M08,2016,4.7,14322,290189,304511
Wyoming,M07,2016,5.0,15458,291468,306926
Wyoming,M06,2016,5.6,17119,291137,308256
Wyoming,M05,2016,5.7,17102,285285,302387
Wyoming,M04,2016,5.9,17953,284041,301994
Wyoming,M03,2016,6.0,18172,283549,301721
Wyoming,M02,2016,5.9,17593,282370,299963
Wyoming,M01,2016,6.0,17939,282221,300160
Wyoming,M12,2015,4.8,14459,286400,300859
Wyoming,M11,2015,4.5,13669,289223,302892
Wyoming,M10,2015,4.0,12303,292008,304311
Wyoming,M09,2015,3.8,11507,292846,304353
Wyoming,M08,2015,3.9,11872,295974,307846
Wyoming,M07,2015,3.9,12214,298031,310245
Wyoming,M06,2015,4.3,13393,297987,311380
Wyoming,M05,2015,4.1,12520,292684,305204
Wyoming,M04,2015,4.2,12692,291737,304429
Wyoming,M03,2015,4.5,13727,290909,304636
Wyoming,M02,2015,4.4,13218,289604,302822
Wyoming,M01,2015,4.6,13961,288847,302808
Wyoming,M12,2014,3.8,11613,292140,303753
Wyoming,M11,2014,4.1,12708,293710,306418
Wyoming,M10,2014,3.7,11213,295522,306735
Wyoming,M09,2014,3.6,11051,295118,306169
Wyoming,M08,2014,3.7,11437,297415,308852
Wyoming,M07,2014,3.8,11871,299347,311218
Wyoming,M06,2014,4.1,12793,299179,311972
Wyoming,M05,2014,4.0,12138,293277,305415
Wyoming,M04,2014,4.3,12986,291622,304608
Wyoming,M03,2014,4.7,14188,290438,304626
Wyoming,M02,2014,4.9,14739,288894,303633
Wyoming,M01,2014,5.2,15920,288145,304065
Wyoming,M12,2013,4.6,14116,291169,305285
Wyoming,M11,2013,4.4,13608,292991,306599
Wyoming,M10,2013,4.2,12765,293795,306560
Wyoming,M09,2013,4.0,12221,293831,306052
Wyoming,M08,2013,4.0,12450,296200,308650
Wyoming,M07,2013,4.2,13026,297804,310830
Wyoming,M06,2013,4.5,13964,297486,311450
Wyoming,M05,2013,4.4,13523,291076,304599
Wyoming,M04,2013,5.1,15457,288972,304429
Wyoming,M03,2013,5.4,16313,288072,304385
Wyoming,M02,2013,5.6,17010,286306,303316
Wyoming,M01,2013,6.1,18473,285515,303988
Wyoming,M12,2012,5.2,15953,289131,305084
Wyoming,M11,2012,5.2,15895,291053,306948
Wyoming,M10,2012,4.8,14863,292400,307263
Wyoming,M09,2012,4.7,14290,292458,306748
Wyoming,M08,2012,4.8,14877,294682,309559
Wyoming,M07,2012,4.9,15333,296107,311440
Wyoming,M06,2012,5.2,16272,295847,312119
Wyoming,M05,2012,5.1,15614,290264,305878
Wyoming,M04,2012,5.5,16686,288985,305671
Wyoming,M03,2012,5.9,18020,288051,306071
Wyoming,M02,2012,6.0,18429,286545,304974
Wyoming,M01,2012,6.5,19787,285664,305451
Wyoming,M12,2011,5.7,17602,289288,306890
Wyoming,M11,2011,5.6,17208,290964,308172
Wyoming,M10,2011,5.2,15985,291953,307938
Wyoming,M09,2011,5.0,15281,291925,307206
Wyoming,M08,2011,5.0,15524,293480,309004
Wyoming,M07,2011,5.1,15966,294785,310751
Wyoming,M06,2011,5.5,17063,293611,310674
Wyoming,M05,2011,5.7,17223,287407,304630
Wyoming,M04,2011,6.2,18719,285574,304293
Wyoming,M03,2011,6.6,20270,284576,304846
Wyoming,M02,2011,6.9,20817,282657,303474
Wyoming,M01,2011,7.2,21891,282012,303903
Wyoming,M12,2010,6.2,18913,285211,304124
Wyoming,M11,2010,6.1,18538,286846,305384
Wyoming,M10,2010,5.5,16735,288143,304878
Wyoming,M09,2010,5.3,16075,287482,303557
Wyoming,M08,2010,5.6,16990,288481,305471
Wyoming,M07,2010,5.6,17261,288923,306184
Wyoming,M06,2010,6.2,19067,288382,307449
Wyoming,M05,2010,6.5,19707,282396,302103
Wyoming,M04,2010,7.0,20935,280119,301054
Wyoming,M03,2010,7.6,22842,277940,300782
Wyoming,M02,2010,7.8,23266,275916,299182
Wyoming,M01,2010,8.1,24303,275085,299388
Wyoming,M12,2009,7.5,22395,278187,300582
Wyoming,M11,2009,6.7,20164,280411,300575
Wyoming,M10,2009,6.3,18947,281258,300205
Wyoming,M09,2009,6.0,17897,281877,299774
Wyoming,M08,2009,6.1,18563,283624,302187
Wyoming,M07,2009,6.3,19226,285377,304603
Wyoming,M06,2009,6.7,20524,285472,305996
Wyoming,M05,2009,6.5,19606,280701,300307
Wyoming,M04,2009,6.8,20307,279343,299650
Wyoming,M03,2009,6.3,18628,279265,297893
Wyoming,M02,2009,5.5,16099,278898,294997
Wyoming,M01,2009,5.2,15280,279390,294670
Wyoming,M12,2008,3.7,10963,283829,294792
Wyoming,M11,2008,3.2,9449,286241,295690
Wyoming,M10,2008,2.7,8123,287757,295880
Wyoming,M09,2008,2.5,7503,287058,294561
Wyoming,M08,2008,2.6,7820,288838,296658
Wyoming,M07,2008,2.7,7982,290296,298278
Wyoming,M06,2008,3.0,8815,289199,298014
Wyoming,M05,2008,2.7,7985,282642,290627
Wyoming,M04,2008,3.0,8714,280489,289203
Wyoming,M03,2008,3.4,9770,279686,289456
Wyoming,M02,2008,3.4,9928,278297,288225
Wyoming,M01,2008,3.7,10575,277387,287962
Wyoming,M12,2007,2.5,7310,279864,287174
Wyoming,M11,2007,2.6,7454,281477,288931
Wyoming,M10,2007,2.4,6967,281475,288442
Wyoming,M09,2007,2.4,6957,280864,287821
Wyoming,M08,2007,2.5,7266,282867,290133
Wyoming,M07,2007,2.7,7813,284232,292045
Wyoming,M06,2007,3.0,8758,283379,292137
Wyoming,M05,2007,2.8,7955,276836,284791
Wyoming,M04,2007,3.0,8390,274526,282916
Wyoming,M03,2007,3.2,9050,273870,282920
Wyoming,M02,2007,3.2,9056,271699,280755
Wyoming,M01,2007,3.5,9910,270745,280655
Wyoming,M12,2006,2.9,8165,273821,281986
Wyoming,M11,2006,3.0,8434,274556,282990
Wyoming,M10,2006,2.8,8003,275053,283056
Wyoming,M09,2006,2.8,7878,274495,282373
Wyoming,M08,2006,2.8,8043,276758,284801
Wyoming,M07,2006,2.9,8227,278231,286458
Wyoming,M06,2006,3.2,9162,277924,287086
Wyoming,M05,2006,3.1,8574,270970,279544
Wyoming,M04,2006,3.2,8885,268844,277729
Wyoming,M03,2006,3.6,10092,267490,277582
Wyoming,M02,2006,3.7,10188,265441,275629
Wyoming,M01,2006,4.1,11277,264451,275728
Wyoming,M12,2005,3.5,9808,266945,276753
Wyoming,M11,2005,3.5,9682,268258,277940
Wyoming,M10,2005,3.3,9132,269217,278349
Wyoming,M09,2005,3.2,8933,268753,277686
Wyoming,M08,2005,3.2,8967,271180,280147
Wyoming,M07,2005,3.3,9322,272743,282065
Wyoming,M06,2005,3.7,10303,271591,281894
Wyoming,M05,2005,3.5,9571,265199,274770
Wyoming,M04,2005,3.5,9672,263350,273022
Wyoming,M03,2005,3.9,10611,262223,272834
Wyoming,M02,2005,4.0,10774,260399,271173
Wyoming,M01,2005,4.4,11990,259696,271686
Wyoming,M12,2004,3.7,10114,262956,273070
Wyoming,M11,2004,3.7,10109,264755,274864
Wyoming,M10,2004,3.4,9468,265604,275072
Wyoming,M09,2004,3.4,9322,265471,274793
Wyoming,M08,2004,3.3,9235,268752,277987
Wyoming,M07,2004,3.4,9499,270774,280273
Wyoming,M06,2004,3.7,10468,269928,280396
Wyoming,M05,2004,3.6,9699,263498,273197
Wyoming,M04,2004,3.8,10236,262174,272410
Wyoming,M03,2004,4.3,11830,260710,272540
Wyoming,M02,2004,4.5,12289,258978,271267
Wyoming,M01,2004,4.9,13403,258251,271654
Wyoming,M12,2003,4.2,11431,261414,272845
Wyoming,M11,2003,4.1,11230,263190,274420
Wyoming,M10,2003,3.6,9990,264693,274683
Wyoming,M09,2003,3.6,9882,264426,274308
Wyoming,M08,2003,3.7,10155,266882,277037
Wyoming,M07,2003,3.8,10561,268238,278799
Wyoming,M06,2003,4.2,11693,267457,279150
Wyoming,M05,2003,4.1,11161,260849,272010
Wyoming,M04,2003,4.5,12179,258798,270977
Wyoming,M03,2003,5.0,13413,257287,270700
Wyoming,M02,2003,5.1,13673,255585,269258
Wyoming,M01,2003,5.4,14428,254817,269245
Wyoming,M12,2002,4.5,12019,257886,269905
Wyoming,M11,2002,4.2,11465,259525,270990
Wyoming,M10,2002,3.6,9842,260575,270417
Wyoming,M09,2002,3.5,9416,260644,270060
Wyoming,M08,2002,3.4,9229,262742,271971
Wyoming,M07,2002,3.5,9564,264617,274181
Wyoming,M06,2002,3.9,10724,263656,274380
Wyoming,M05,2002,3.8,10127,257587,267714
Wyoming,M04,2002,4.2,11267,255617,266884
Wyoming,M03,2002,4.6,12291,254881,267172
Wyoming,M02,2002,4.5,12011,253312,265323
Wyoming,M01,2002,4.8,12795,252757,265552
Wyoming,M12,2001,3.9,10512,256858,267370
Wyoming,M11,2001,3.8,10125,259121,269246
Wyoming,M10,2001,3.4,9049,260403,269452
Wyoming,M09,2001,3.3,8914,260549,269463
Wyoming,M08,2001,3.3,9063,263872,272935
Wyoming,M07,2001,3.4,9382,265572,274954
Wyoming,M06,2001,3.8,10364,265112,275476
Wyoming,M05,2001,3.6,9554,258462,268016
Wyoming,M04,2001,3.8,10228,256591,266819
Wyoming,M03,2001,4.4,11665,255599,267264
Wyoming,M02,2001,4.4,11691,253770,265461
Wyoming,M01,2001,4.8,12691,253163,265854
Wyoming,M12,2000,3.9,10373,256296,266669
Wyoming,M11,2000,4.0,10603,257697,268300
Wyoming,M10,2000,3.4,9144,259019,268163
Wyoming,M09,2000,3.4,9015,258491,267506
Wyoming,M08,2000,3.4,9249,261379,270628
Wyoming,M07,2000,3.4,9281,262929,272210
Wyoming,M06,2000,3.7,10139,261767,271906
Wyoming,M05,2000,3.6,9465,255291,264756
Wyoming,M04,2000,3.9,10164,253439,263603
Wyoming,M03,2000,4.4,11666,252189,263855
Wyoming,M02,2000,4.7,12280,249829,262109
Wyoming,M01,2000,5.1,13349,248642,261991
Missouri,M12,2016,3.9,121063,2960244,3081307
Missouri,M11,2016,3.7,114870,2977005,3091875
Missouri,M10,2016,4.1,126662,2980762,3107424
Missouri,M09,2016,4.6,141820,2966693,3108513
Missouri,M08,2016,5.2,160287,2947466,3107753
Missouri,M07,2016,5.2,162471,2983307,3145778
Missouri,M06,2016,4.9,155158,2997602,3152760
Missouri,M05,2016,4.2,130546,2989098,3119644
Missouri,M04,2016,4.3,133954,2983545,3117499
Missouri,M03,2016,4.8,151038,2967695,3118733
Missouri,M02,2016,4.9,151362,2953231,3104593
Missouri,M01,2016,4.6,140552,2941776,3082328
Missouri,M12,2015,4.0,122050,2954650,3076700
Missouri,M11,2015,4.0,121913,2962438,3084351
Missouri,M10,2015,4.0,124287,2965310,3089597
Missouri,M09,2015,4.3,131446,2940930,3072376
Missouri,M08,2015,4.9,150512,2930608,3081120
Missouri,M07,2015,5.3,166679,2958202,3124881
Missouri,M06,2015,5.3,164733,2972304,3137037
Missouri,M05,2015,5.2,164207,2964443,3128650
Missouri,M04,2015,5.2,160559,2950758,3111317
Missouri,M03,2015,5.8,178804,2912125,3090929
Missouri,M02,2015,6.1,189039,2897617,3086656
Missouri,M01,2015,6.0,184052,2892463,3076515
Missouri,M12,2014,5.0,154159,2903488,3057647
Missouri,M11,2014,5.0,154259,2916570,3070829
Missouri,M10,2014,4.9,151872,2925615,3077487
Missouri,M09,2014,5.6,170402,2888338,3058740
Missouri,M08,2014,6.2,188824,2861746,3050570
Missouri,M07,2014,6.5,201120,2887289,3088409
Missouri,M06,2014,6.3,195199,2895772,3090971
Missouri,M05,2014,6.1,186797,2875675,3062472
Missouri,M04,2014,5.7,173377,2867157,3040534
Missouri,M03,2014,7.2,219153,2834522,3053675
Missouri,M02,2014,7.6,231822,2807853,3039675
Missouri,M01,2014,7.1,213399,2804389,3017788
Missouri,M12,2013,6.1,184224,2819343,3003567
Missouri,M11,2013,5.8,174732,2831034,3005766
Missouri,M10,2013,6.0,179397,2823821,3003218
Missouri,M09,2013,6.2,187936,2828413,3016349
Missouri,M08,2013,6.9,209836,2812953,3022789
Missouri,M07,2013,7.2,220769,2845559,3066328
Missouri,M06,2013,7.1,217602,2854191,3071793
Missouri,M05,2013,6.6,200014,2842345,3042359
Missouri,M04,2013,6.1,183662,2836086,3019748
Missouri,M03,2013,7.0,210894,2793901,3004795
Missouri,M02,2013,7.5,224737,2781130,3005867
Missouri,M01,2013,7.6,227213,2780371,3007584
Missouri,M12,2012,6.6,198833,2813392,3012225
Missouri,M11,2012,6.2,185633,2828955,3014588
Missouri,M10,2012,6.3,190777,2847046,3037823
Missouri,M09,2012,6.3,190049,2827305,3017354
Missouri,M08,2012,7.2,215507,2796463,3011970
Missouri,M07,2012,7.5,228293,2828331,3056624
Missouri,M06,2012,7.0,215208,2846143,3061351
Missouri,M05,2012,6.7,201832,2832280,3034112
Missouri,M04,2012,6.5,196485,2818753,3015238
Missouri,M03,2012,7.6,230098,2793309,3023407
Missouri,M02,2012,7.9,239946,2778562,3018508
Missouri,M01,2012,7.6,227747,2772758,3000505
Missouri,M12,2011,7.3,219990,2801320,3021310
Missouri,M11,2011,7.2,218735,2813123,3031858
Missouri,M10,2011,7.6,232968,2815754,3048722
Missouri,M09,2011,8.1,247831,2795990,3043821
Missouri,M08,2011,8.8,268178,2780074,3048252
Missouri,M07,2011,8.6,262232,2804070,3066302
Missouri,M06,2011,8.8,273113,2813392,3086505
Missouri,M05,2011,8.4,256809,2801432,3058241
Missouri,M04,2011,8.2,251151,2798054,3049205
Missouri,M03,2011,9.2,279004,2768362,3047366
Missouri,M02,2011,9.7,295449,2741939,3037388
Missouri,M01,2011,9.8,297278,2737172,3034450
Missouri,M12,2010,9.2,279008,2760478,3039486
Missouri,M11,2010,9.3,284527,2765949,3050476
Missouri,M10,2010,9.0,274341,2777418,3051759
Missouri,M09,2010,9.2,282631,2776208,3058839
Missouri,M08,2010,9.7,297072,2766646,3063718
Missouri,M07,2010,9.8,301805,2783885,3085690
Missouri,M06,2010,9.5,292667,2798783,3091450
Missouri,M05,2010,9.1,277942,2786134,3064076
Missouri,M04,2010,9.3,286167,2788248,3074415
Missouri,M03,2010,10.2,308911,2733945,3042856
Missouri,M02,2010,10.5,318362,2713836,3032198
Missouri,M01,2010,10.3,311956,2710887,3022843
Missouri,M12,2009,9.4,283720,2724608,3008328
Missouri,M11,2009,9.3,283064,2752181,3035245
Missouri,M10,2009,9.2,280258,2757037,3037295
Missouri,M09,2009,9.4,286605,2753264,3039869
Missouri,M08,2009,9.7,297961,2761096,3059057
Missouri,M07,2009,9.7,299211,2797718,3096929
Missouri,M06,2009,9.7,301238,2809948,3111186
Missouri,M05,2009,9.0,273912,2786405,3060317
Missouri,M04,2009,8.2,248835,2796257,3045092
Missouri,M03,2009,9.3,284027,2754267,3038294
Missouri,M02,2009,9.5,287021,2748984,3036005
Missouri,M01,2009,8.9,268369,2758772,3027141
Missouri,M12,2008,7.4,222544,2803968,3026512
Missouri,M11,2008,6.7,202975,2830546,3033521
Missouri,M10,2008,6.3,192878,2849724,3042602
Missouri,M09,2008,6.4,192780,2834655,3027435
Missouri,M08,2008,6.8,205860,2828509,3034369
Missouri,M07,2008,6.5,198975,2868262,3067237
Missouri,M06,2008,5.9,182146,2885278,3067424
Missouri,M05,2008,5.6,168896,2860996,3029892
Missouri,M04,2008,4.7,140886,2869852,3010738
Missouri,M03,2008,5.8,174265,2832105,3006370
Missouri,M02,2008,5.8,174787,2818809,2993596
Missouri,M01,2008,5.8,175150,2831436,3006586
Missouri,M12,2007,5.4,161778,2858250,3020028
Missouri,M11,2007,5.0,150370,2879793,3030163
Missouri,M10,2007,5.0,152625,2879505,3032130
Missouri,M09,2007,5.2,157331,2871136,3028467
Missouri,M08,2007,5.4,163269,2858149,3021418
Missouri,M07,2007,5.5,168127,2899229,3067356
Missouri,M06,2007,5.2,160412,2915931,3076343
Missouri,M05,2007,4.6,137860,2891603,3029463
Missouri,M04,2007,4.3,130889,2892558,3023447
Missouri,M03,2007,4.9,149193,2881696,3030889
Missouri,M02,2007,5.4,164900,2861404,3026304
Missouri,M01,2007,5.4,162434,2866505,3028939
Missouri,M12,2006,4.6,141507,2908055,3049562
Missouri,M11,2006,4.6,141041,2911814,3052855
Missouri,M10,2006,4.5,137366,2917412,3054778
Missouri,M09,2006,4.8,144494,2884177,3028671
Missouri,M08,2006,5.2,156624,2880878,3037502
Missouri,M07,2006,5.1,157155,2906397,3063552
Missouri,M06,2006,4.9,149146,2914786,3063932
Missouri,M05,2006,4.3,130119,2885956,3016075
Missouri,M04,2006,4.4,132899,2880060,3012959
Missouri,M03,2006,5.0,150316,2848346,2998662
Missouri,M02,2006,5.6,166981,2828684,2995665
Missouri,M01,2006,5.2,155538,2826524,2982062
Missouri,M12,2005,4.6,138998,2853540,2992538
Missouri,M11,2005,5.2,156309,2857147,3013456
Missouri,M10,2005,4.6,138631,2873371,3012002
Missouri,M09,2005,4.9,146951,2850032,2996983
Missouri,M08,2005,4.9,146752,2857172,3003924
Missouri,M07,2005,5.4,165935,2879196,3045131
Missouri,M06,2005,5.5,168115,2881324,3049439
Missouri,M05,2005,5.3,159957,2855423,3015380
Missouri,M04,2005,5.3,160188,2848758,3008946
Missouri,M03,2005,6.1,182635,2809501,2992136
Missouri,M02,2005,6.6,196544,2797391,2993935
Missouri,M01,2005,6.3,186917,2801218,2988135
Missouri,M12,2004,5.7,171491,2829173,3000664
Missouri,M11,2004,5.7,172681,2841684,3014365
Missouri,M10,2004,5.5,165807,2845967,3011774
Missouri,M09,2004,5.8,174348,2823171,2997519
Missouri,M08,2004,6.2,186553,2829111,3015664
Missouri,M07,2004,6.4,194516,2861882,3056398
Missouri,M06,2004,6.2,189563,2868528,3058091
Missouri,M05,2004,5.5,166223,2843040,3009263
Missouri,M04,2004,5.4,160874,2845381,3006255
Missouri,M03,2004,6.0,181711,2827136,3008847
Missouri,M02,2004,6.0,180501,2824879,3005380
Missouri,M01,2004,5.9,177064,2826506,3003570
Missouri,M12,2003,5.1,153224,2851109,3004333
Missouri,M11,2003,5.2,156514,2858796,3015310
Missouri,M10,2003,5.1,154858,2862360,3017218
Missouri,M09,2003,5.6,168632,2835742,3004374
Missouri,M08,2003,5.9,178789,2833619,3012408
Missouri,M07,2003,6.0,182190,2865030,3047220
Missouri,M06,2003,6.3,194077,2888384,3082461
Missouri,M05,2003,5.6,170381,2861790,3032171
Missouri,M04,2003,5.2,156878,2868297,3025175
Missouri,M03,2003,5.7,171989,2838819,3010808
Missouri,M02,2003,5.8,174641,2826990,3001631
Missouri,M01,2003,5.9,175836,2820905,2996741
Missouri,M12,2002,5.2,154755,2840335,2995090
Missouri,M11,2002,5.0,149278,2839947,2989225
Missouri,M10,2002,4.6,138810,2865201,3004011
Missouri,M09,2002,4.9,146317,2851716,2998033
Missouri,M08,2002,5.4,160345,2831288,2991633
Missouri,M07,2002,5.7,172296,2848712,3021008
Missouri,M06,2002,5.8,175529,2866058,3041587
Missouri,M05,2002,5.1,154096,2848358,3002454
Missouri,M04,2002,5.3,157668,2843336,3001004
Missouri,M03,2002,6.0,179775,2824098,3003873
Missouri,M02,2002,5.8,174796,2820735,2995531
Missouri,M01,2002,5.9,173628,2793825,2967453
Missouri,M12,2001,4.9,146942,2833038,2979980
Missouri,M11,2001,4.8,142272,2835473,2977745
Missouri,M10,2001,4.5,133004,2853444,2986448
Missouri,M09,2001,4.3,128896,2845435,2974331
Missouri,M08,2001,4.7,141152,2831221,2972373
Missouri,M07,2001,4.5,134979,2888329,3023308
Missouri,M06,2001,4.6,139052,2901994,3041046
Missouri,M05,2001,3.9,116801,2883107,2999908
Missouri,M04,2001,4.2,125303,2887366,3012669
Missouri,M03,2001,5.0,150284,2875244,3025528
Missouri,M02,2001,5.1,153857,2860678,3014535
Missouri,M01,2001,5.0,150985,2858731,3009716
Missouri,M12,2000,4.0,119322,2884360,3003682
Missouri,M11,2000,3.6,105656,2868503,2974159
Missouri,M10,2000,3.5,104466,2869009,2973475
Missouri,M09,2000,3.6,106154,2838335,2944489
Missouri,M08,2000,3.8,110570,2835218,2945788
Missouri,M07,2000,3.5,103800,2862789,2966589
Missouri,M06,2000,3.4,100885,2891263,2992148
Missouri,M05,2000,3.3,98494,2852041,2950535
Missouri,M04,2000,3.0,89562,2869202,2958764
Missouri,M03,2000,3.9,116439,2835515,2951954
Missouri,M02,2000,3.9,114229,2822876,2937105
Missouri,M01,2000,3.5,103087,2817585,2920672
Ohio,M12,2016,4.8,269865,5393622,5663487
Ohio,M11,2016,4.5,256301,5436147,5692448
Ohio,M10,2016,4.7,268016,5454180,5722196
Ohio,M09,2016,4.9,281698,5438003,5719701
Ohio,M08,2016,4.8,278828,5475617,5754445
Ohio,M07,2016,5.0,289528,5488989,5778517
Ohio,M06,2016,5.0,286907,5467545,5754452
Ohio,M05,2016,4.4,250260,5463647,5713907
Ohio,M04,2016,4.8,272309,5434335,5706644
Ohio,M03,2016,5.3,304346,5409031,5713377
Ohio,M02,2016,5.5,311702,5376613,5688315
Ohio,M01,2016,5.6,317810,5331747,5649557
Ohio,M12,2015,4.7,268825,5410556,5679381
Ohio,M11,2015,4.5,257198,5437019,5694217
Ohio,M10,2015,4.3,245071,5448663,5693734
Ohio,M09,2015,4.3,245460,5406217,5651677
Ohio,M08,2015,4.4,250912,5457911,5708823
Ohio,M07,2015,5.0,286766,5462691,5749457
Ohio,M06,2015,5.1,290847,5453323,5744170
Ohio,M05,2015,4.9,279280,5453585,5732865
Ohio,M04,2015,4.6,263315,5413459,5676774
Ohio,M03,2015,5.2,296597,5361057,5657654
Ohio,M02,2015,5.6,318415,5338278,5656693
Ohio,M01,2015,6.1,343904,5310353,5654257
Ohio,M12,2014,4.9,280747,5395830,5676577
Ohio,M11,2014,4.9,282794,5434222,5717016
Ohio,M10,2014,4.9,281296,5454380,5735676
Ohio,M09,2014,5.2,295940,5399339,5695279
Ohio,M08,2014,5.6,322595,5418185,5740780
Ohio,M07,2014,6.2,356921,5415987,5772908
Ohio,M06,2014,5.9,338626,5401650,5740276
Ohio,M05,2014,5.5,312299,5383049,5695348
Ohio,M04,2014,5.2,295363,5343328,5638691
Ohio,M03,2014,6.5,370271,5295127,5665398
Ohio,M02,2014,7.2,406555,5247923,5654478
Ohio,M01,2014,7.5,421570,5218358,5639928
Ohio,M12,2013,6.5,365968,5297561,5663529
Ohio,M11,2013,6.8,386846,5327984,5714830
Ohio,M10,2013,7.2,412490,5307540,5720030
Ohio,M09,2013,7.2,412950,5313590,5726540
Ohio,M08,2013,7.3,422008,5340244,5762252
Ohio,M07,2013,7.8,450560,5349870,5800430
Ohio,M06,2013,8.0,461121,5332194,5793315
Ohio,M05,2013,7.2,412555,5325918,5738473
Ohio,M04,2013,6.9,391974,5283533,5675507
Ohio,M03,2013,7.7,432891,5220014,5652905
Ohio,M02,2013,8.3,470970,5195717,5666687
Ohio,M01,2013,8.9,502898,5165677,5668575
Ohio,M12,2012,7.3,414895,5271711,5686606
Ohio,M11,2012,6.7,380262,5311581,5691843
Ohio,M10,2012,6.8,389148,5347627,5736775
Ohio,M09,2012,6.7,383100,5303586,5686686
Ohio,M08,2012,7.2,413385,5315968,5729353
Ohio,M07,2012,7.8,448871,5328038,5776909
Ohio,M06,2012,7.5,434855,5329746,5764601
Ohio,M05,2012,6.9,395787,5316510,5712297
Ohio,M04,2012,7.0,394084,5275296,5669380
Ohio,M03,2012,7.8,443571,5242330,5685901
Ohio,M02,2012,8.4,474445,5201975,5676420
Ohio,M01,2012,8.6,486679,5163646,5650325
Ohio,M12,2011,7.7,442197,5268721,5710918
Ohio,M11,2011,7.6,435448,5303512,5738960
Ohio,M10,2011,8.2,471951,5309295,5781246
Ohio,M09,2011,8.6,496411,5284476,5780887
Ohio,M08,2011,8.9,516746,5312333,5829079
Ohio,M07,2011,9.4,547106,5296459,5843565
Ohio,M06,2011,9.4,548916,5277856,5826772
Ohio,M05,2011,8.7,503046,5279122,5782168
Ohio,M04,2011,8.5,489517,5257348,5746865
Ohio,M03,2011,9.2,529999,5217804,5747803
Ohio,M02,2011,9.8,559437,5178332,5737769
Ohio,M01,2011,10.2,581995,5149596,5731591
Ohio,M12,2010,9.2,533897,5242810,5776707
Ohio,M11,2010,9.4,548930,5269991,5818921
Ohio,M10,2010,9.3,539529,5291503,5831032
Ohio,M09,2010,9.5,552527,5275938,5828465
Ohio,M08,2010,9.8,577175,5312855,5890030
Ohio,M07,2010,10.1,598459,5304299,5902758
Ohio,M06,2010,10.2,598568,5288586,5887154
Ohio,M05,2010,9.9,580776,5281044,5861820
Ohio,M04,2010,10.4,611367,5260818,5872185
Ohio,M03,2010,11.4,668027,5176370,5844397
Ohio,M02,2010,11.9,691096,5140158,5831254
Ohio,M01,2010,12.0,697677,5120231,5817908
Ohio,M12,2009,10.8,625935,5194828,5820763
Ohio,M11,2009,10.3,604317,5261364,5865681
Ohio,M10,2009,10.3,607471,5270157,5877628
Ohio,M09,2009,10.3,602544,5262875,5865419
Ohio,M08,2009,10.3,611786,5328794,5940580
Ohio,M07,2009,10.7,643224,5347173,5990397
Ohio,M06,2009,10.9,653121,5329761,5982882
Ohio,M05,2009,10.2,605407,5322841,5928248
Ohio,M04,2009,9.9,582281,5321609,5903890
Ohio,M03,2009,10.3,609409,5294517,5903926
Ohio,M02,2009,10.2,603573,5308071,5911644
Ohio,M01,2009,9.6,566975,5323184,5890159
Ohio,M12,2008,7.7,457273,5461177,5918450
Ohio,M11,2008,6.9,407711,5534480,5942191
Ohio,M10,2008,6.5,390440,5590063,5980503
Ohio,M09,2008,6.5,385745,5575806,5961551
Ohio,M08,2008,6.8,410768,5624347,6035115
Ohio,M07,2008,7.0,422622,5648482,6071104
Ohio,M06,2008,6.5,393931,5636132,6030063
Ohio,M05,2008,5.9,353803,5622689,5976492
Ohio,M04,2008,5.3,314429,5610020,5924449
Ohio,M03,2008,6.0,356557,5563976,5920533
Ohio,M02,2008,5.9,350844,5550371,5901215
Ohio,M01,2008,6.2,367749,5552569,5920318
Ohio,M12,2007,5.6,335509,5641971,5977480
Ohio,M11,2007,5.1,308574,5698221,6006795
Ohio,M10,2007,5.2,310101,5692286,6002387
Ohio,M09,2007,5.4,322311,5673660,5995971
Ohio,M08,2007,5.4,325694,5700104,6025798
Ohio,M07,2007,5.8,351064,5717863,6068927
Ohio,M06,2007,5.8,352025,5705144,6057169
Ohio,M05,2007,5.2,312948,5668037,5980985
Ohio,M04,2007,5.5,326114,5630836,5956950
Ohio,M03,2007,5.5,328319,5621535,5949854
Ohio,M02,2007,5.9,348758,5575358,5924116
Ohio,M01,2007,6.2,369465,5567604,5937069
Ohio,M12,2006,5.2,310640,5678785,5989425
Ohio,M11,2006,5.2,309349,5689904,5999253
Ohio,M10,2006,4.8,287153,5703511,5990664
Ohio,M09,2006,5.2,310182,5651630,5961812
Ohio,M08,2006,5.4,327589,5693746,6021335
Ohio,M07,2006,5.8,352652,5682111,6034763
Ohio,M06,2006,5.4,325442,5660705,5986147
Ohio,M05,2006,5.1,299538,5620935,5920473
Ohio,M04,2006,5.3,314381,5580850,5895231
Ohio,M03,2006,5.5,323822,5545984,5869806
Ohio,M02,2006,5.9,346449,5506014,5852463
Ohio,M01,2006,5.9,345368,5479046,5824414
Ohio,M12,2005,5.4,316296,5571664,5887960
Ohio,M11,2005,5.6,332006,5591969,5923975
Ohio,M10,2005,5.3,315153,5613771,5928924
Ohio,M09,2005,5.7,334329,5574874,5909203
Ohio,M08,2005,5.4,321451,5626592,5948043
Ohio,M07,2005,5.8,344837,5615988,5960825
Ohio,M06,2005,6.0,354534,5576543,5931077
Ohio,M05,2005,5.7,332940,5549934,5882874
Ohio,M04,2005,5.9,347345,5509744,5857089
Ohio,M03,2005,6.5,379969,5449412,5829381
Ohio,M02,2005,7.1,413095,5416821,5829916
Ohio,M01,2005,6.8,395614,5395666,5791280
Ohio,M12,2004,6.0,352246,5506061,5858307
Ohio,M11,2004,6.1,359565,5540989,5900554
Ohio,M10,2004,6.0,353240,5548493,5901733
Ohio,M09,2004,5.9,346687,5512359,5859046
Ohio,M08,2004,6.0,353761,5565016,5918777
Ohio,M07,2004,6.4,381998,5571700,5953698
Ohio,M06,2004,6.5,384808,5531978,5916786
Ohio,M05,2004,5.9,343997,5503230,5847227
Ohio,M04,2004,6.1,354501,5477147,5831648
Ohio,M03,2004,6.7,393461,5443490,5836951
Ohio,M02,2004,6.7,388927,5424524,5813451
Ohio,M01,2004,6.9,403223,5404337,5807560
Ohio,M12,2003,5.7,331548,5499088,5830636
Ohio,M11,2003,5.6,330788,5529050,5859838
Ohio,M10,2003,5.5,320663,5540170,5860833
Ohio,M09,2003,5.8,339401,5504262,5843663
Ohio,M08,2003,6.0,354378,5551429,5905807
Ohio,M07,2003,6.6,390769,5551072,5941841
Ohio,M06,2003,7.0,414263,5539637,5953900
Ohio,M05,2003,6.1,357774,5520665,5878439
Ohio,M04,2003,6.2,365226,5503510,5868736
Ohio,M03,2003,6.7,394713,5463081,5857794
Ohio,M02,2003,6.9,401197,5443020,5844217
Ohio,M01,2003,6.8,397442,5425308,5822750
Ohio,M12,2002,5.6,329678,5507381,5837059
Ohio,M11,2002,5.4,318180,5528889,5847069
Ohio,M10,2002,5.1,298680,5566310,5864990
Ohio,M09,2002,5.1,298689,5552170,5850859
Ohio,M08,2002,5.4,318804,5570165,5888969
Ohio,M07,2002,6.0,353076,5562363,5915439
Ohio,M06,2002,6.0,355933,5544287,5900220
Ohio,M05,2002,5.5,323019,5530084,5853103
Ohio,M04,2002,5.9,345173,5491459,5836632
Ohio,M03,2002,6.2,361661,5472785,5834446
Ohio,M02,2002,6.2,362369,5461986,5824355
Ohio,M01,2002,6.4,370821,5411856,5782677
Ohio,M12,2001,5.1,295114,5534705,5829819
Ohio,M11,2001,4.8,279065,5560589,5839654
Ohio,M10,2001,4.4,258157,5584148,5842305
Ohio,M09,2001,4.2,244825,5564029,5808854
Ohio,M08,2001,4.3,252686,5587750,5840436
Ohio,M07,2001,4.2,248925,5624033,5872958
Ohio,M06,2001,4.3,250537,5602379,5852916
Ohio,M05,2001,3.5,203993,5585393,5789386
Ohio,M04,2001,3.8,217346,5563630,5780976
Ohio,M03,2001,4.1,239645,5556150,5795795
Ohio,M02,2001,4.3,245857,5527803,5773660
Ohio,M01,2001,4.5,260269,5514950,5775219
Ohio,M12,2000,3.4,199023,5595243,5794266
Ohio,M11,2000,3.4,199389,5590909,5790298
Ohio,M10,2000,3.4,193876,5590401,5784277
Ohio,M09,2000,3.7,213002,5550166,5763168
Ohio,M08,2000,4.0,235871,5595175,5831046
Ohio,M07,2000,4.3,250051,5598318,5848369
Ohio,M06,2000,4.2,246086,5597519,5843605
Ohio,M05,2000,3.7,216064,5557481,5773545
Ohio,M04,2000,3.7,213024,5549856,5762880
Ohio,M03,2000,4.4,256027,5513053,5769080
Ohio,M02,2000,4.7,272305,5482963,5755268
Ohio,M01,2000,4.8,272315,5460003,5732318
North Carolina,M12,2016,4.9,238340,4649833,4888173
North Carolina,M11,2016,4.9,241445,4679561,4921006
North Carolina,M10,2016,5.1,251212,4676813,4928025
North Carolina,M09,2016,5.0,243039,4659869,4902908
North Carolina,M08,2016,5.3,255587,4611920,4867507
North Carolina,M07,2016,5.2,257157,4646668,4903825
North Carolina,M06,2016,5.2,252690,4624642,4877332
North Carolina,M05,2016,4.7,227259,4644799,4872058
North Carolina,M04,2016,4.7,228678,4626717,4855395
North Carolina,M03,2016,5.0,245221,4626137,4871358
North Carolina,M02,2016,5.3,255584,4582084,4837668
North Carolina,M01,2016,5.4,260255,4522909,4783164
North Carolina,M12,2015,5.2,248697,4518729,4767426
North Carolina,M11,2015,5.4,259919,4527173,4787092
North Carolina,M10,2015,5.4,259883,4531503,4791386
North Carolina,M09,2015,5.4,256447,4500051,4756498
North Carolina,M08,2015,6.0,284530,4471466,4755996
North Carolina,M07,2015,6.3,302495,4503037,4805532
North Carolina,M06,2015,6.2,295730,4504367,4800097
North Carolina,M05,2015,6.1,292752,4532922,4825674
North Carolina,M04,2015,5.4,259350,4501164,4760514
North Carolina,M03,2015,5.6,266818,4475020,4741838
North Carolina,M02,2015,5.9,279674,4447438,4727112
North Carolina,M01,2015,6.1,285454,4413986,4699440
North Carolina,M12,2014,5.4,251827,4417407,4669234
North Carolina,M11,2014,5.7,268103,4443513,4711616
North Carolina,M10,2014,5.7,267677,4460977,4728654
North Carolina,M09,2014,5.8,274008,4414661,4688669
North Carolina,M08,2014,6.8,317314,4364856,4682170
North Carolina,M07,2014,6.9,326056,4401825,4727881
North Carolina,M06,2014,6.5,305647,4399101,4704748
North Carolina,M05,2014,6.4,302712,4411559,4714271
North Carolina,M04,2014,5.8,272459,4389892,4662351
North Carolina,M03,2014,6.7,313869,4375294,4689163
North Carolina,M02,2014,7.0,324274,4324755,4649029
North Carolina,M01,2014,6.9,320157,4307915,4628072
North Carolina,M12,2013,6.6,303346,4320232,4623578
North Carolina,M11,2013,6.9,323431,4346716,4670147
North Carolina,M10,2013,7.2,337245,4328775,4666020
North Carolina,M09,2013,7.2,337624,4351355,4688979
North Carolina,M08,2013,7.9,368656,4303997,4672653
North Carolina,M07,2013,8.4,394884,4329623,4724507
North Carolina,M06,2013,8.6,404913,4314612,4719525
North Carolina,M05,2013,8.1,383987,4336831,4720818
North Carolina,M04,2013,7.8,365892,4309039,4674931
North Carolina,M03,2013,8.3,389249,4277740,4666989
North Carolina,M02,2013,9.1,424318,4251908,4676226
North Carolina,M01,2013,9.7,451631,4224393,4676024
North Carolina,M12,2012,9.0,421319,4261720,4683039
North Carolina,M11,2012,8.7,410004,4295946,4705950
North Carolina,M10,2012,8.8,415617,4322419,4738036
North Carolina,M09,2012,8.7,407653,4296670,4704323
North Carolina,M08,2012,9.6,449129,4222744,4671873
North Carolina,M07,2012,9.9,465525,4248097,4713622
North Carolina,M06,2012,9.7,454476,4248027,4702503
North Carolina,M05,2012,9.2,431458,4268316,4699774
North Carolina,M04,2012,8.7,404690,4236573,4641263
North Carolina,M03,2012,9.3,432573,4220494,4653067
North Carolina,M02,2012,9.9,458754,4181213,4639967
North Carolina,M01,2012,10.0,461382,4145880,4607262
North Carolina,M12,2011,9.7,446758,4173610,4620368
North Carolina,M11,2011,9.6,447183,4202302,4649485
North Carolina,M10,2011,9.9,461826,4200603,4662429
North Carolina,M09,2011,10.2,473371,4184664,4658035
North Carolina,M08,2011,10.7,495241,4148329,4643570
North Carolina,M07,2011,10.7,497971,4159876,4657847
North Carolina,M06,2011,10.8,501822,4149670,4651492
North Carolina,M05,2011,10.1,469114,4179533,4648647
North Carolina,M04,2011,9.9,457156,4168831,4625987
North Carolina,M03,2011,10.2,468811,4143642,4612453
North Carolina,M02,2011,10.6,486533,4101298,4587831
North Carolina,M01,2011,10.9,500556,4078162,4578718
North Carolina,M12,2010,10.3,473066,4106669,4579735
North Carolina,M11,2010,10.5,485936,4132539,4618475
North Carolina,M10,2010,9.9,456081,4150920,4607001
North Carolina,M09,2010,10.0,459133,4152584,4611717
North Carolina,M08,2010,10.5,486253,4137732,4623985
North Carolina,M07,2010,10.8,503704,4150739,4654443
North Carolina,M06,2010,10.9,503871,4137291,4641162
North Carolina,M05,2010,10.9,506280,4157243,4663523
North Carolina,M04,2010,10.9,508509,4149161,4657670
North Carolina,M03,2010,11.5,530778,4072876,4603654
North Carolina,M02,2010,12.0,549878,4028297,4578175
North Carolina,M01,2010,12.0,549257,4011491,4560748
North Carolina,M12,2009,11.0,495639,4014071,4509710
North Carolina,M11,2009,10.6,482345,4070205,4552550
North Carolina,M10,2009,10.6,482205,4069515,4551720
North Carolina,M09,2009,10.4,472231,4076322,4548553
North Carolina,M08,2009,10.6,485802,4083402,4569204
North Carolina,M07,2009,10.8,498541,4121528,4620069
North Carolina,M06,2009,10.8,498908,4102835,4601743
North Carolina,M05,2009,10.6,484666,4109190,4593856
North Carolina,M04,2009,10.1,464094,4115581,4579675
North Carolina,M03,2009,10.5,481683,4084718,4566401
North Carolina,M02,2009,10.7,491633,4090537,4582170
North Carolina,M01,2009,10.2,466462,4107357,4573819
North Carolina,M12,2008,8.7,400586,4190259,4590845
North Carolina,M11,2008,7.9,362969,4251847,4614816
North Carolina,M10,2008,6.0,276569,4295405,4571974
North Carolina,M09,2008,5.9,268607,4292928,4561535
North Carolina,M08,2008,6.3,288553,4282651,4571204
North Carolina,M07,2008,6.3,289018,4324163,4613181
North Carolina,M06,2008,5.9,271173,4313781,4584954
North Carolina,M05,2008,5.5,253099,4311171,4564270
North Carolina,M04,2008,4.9,221212,4312621,4533833
North Carolina,M03,2008,5.2,232743,4283548,4516291
North Carolina,M02,2008,5.3,236310,4256975,4493285
North Carolina,M01,2008,5.3,239310,4265206,4504516
North Carolina,M12,2007,4.9,219046,4291281,4510327
North Carolina,M11,2007,4.6,210058,4334399,4544457
North Carolina,M10,2007,4.5,202372,4324792,4527164
North Carolina,M09,2007,4.5,201890,4321920,4523810
North Carolina,M08,2007,4.7,212508,4299171,4511679
North Carolina,M07,2007,5.1,231083,4336375,4567458
North Carolina,M06,2007,4.9,220499,4323332,4543831
North Carolina,M05,2007,4.6,206181,4304608,4510789
North Carolina,M04,2007,4.5,201393,4283449,4484842
North Carolina,M03,2007,4.4,198903,4288740,4487643
North Carolina,M02,2007,4.9,219842,4251135,4470977
North Carolina,M01,2007,5.1,226854,4244440,4471294
North Carolina,M12,2006,4.5,200462,4300107,4500569
North Carolina,M11,2006,4.7,214579,4310627,4525206
North Carolina,M10,2006,4.4,198222,4312934,4511156
North Carolina,M09,2006,4.6,205087,4272875,4477962
North Carolina,M08,2006,5.0,223395,4265656,4489051
North Carolina,M07,2006,5.2,236655,4276037,4512692
North Carolina,M06,2006,5.0,222631,4247687,4470318
North Carolina,M05,2006,4.7,208846,4224387,4433233
North Carolina,M04,2006,4.5,196024,4199968,4395992
North Carolina,M03,2006,4.6,200454,4163296,4363750
North Carolina,M02,2006,5.0,218569,4125982,4344551
North Carolina,M01,2006,4.8,205540,4109586,4315126
North Carolina,M12,2005,4.5,193679,4128448,4322127
North Carolina,M11,2005,5.0,217301,4135176,4352477
North Carolina,M10,2005,4.8,210923,4151658,4362581
North Carolina,M09,2005,4.9,214476,4122213,4336689
North Carolina,M08,2005,5.1,223333,4123253,4346586
North Carolina,M07,2005,5.6,244247,4131208,4375455
North Carolina,M06,2005,5.5,240573,4095949,4336522
North Carolina,M05,2005,5.2,225868,4092106,4317974
North Carolina,M04,2005,5.1,220817,4076782,4297599
North Carolina,M03,2005,5.4,229853,4036864,4266717
North Carolina,M02,2005,6.0,253712,4005145,4258857
North Carolina,M01,2005,5.7,241881,3993671,4235552
North Carolina,M12,2004,5.2,222758,4030290,4253048
North Carolina,M11,2004,5.3,225313,4047788,4273101
North Carolina,M10,2004,4.9,210154,4048562,4258716
North Carolina,M09,2004,4.7,197732,4031579,4229311
North Carolina,M08,2004,5.2,220284,4035989,4256273
North Carolina,M07,2004,5.6,240323,4060788,4301111
North Carolina,M06,2004,5.9,251055,4024276,4275331
North Carolina,M05,2004,5.5,231742,4016782,4248524
North Carolina,M04,2004,5.4,228797,4009336,4238133
North Carolina,M03,2004,5.9,250118,3987699,4237817
North Carolina,M02,2004,6.0,255398,3976964,4232362
North Carolina,M01,2004,6.3,266128,3967652,4233780
North Carolina,M12,2003,5.6,236169,3999124,4235293
North Carolina,M11,2003,6.1,260058,4012360,4272418
North Carolina,M10,2003,5.9,252490,4015513,4268003
North Carolina,M09,2003,6.0,253125,3979320,4232445
North Carolina,M08,2003,6.5,275920,3975556,4251476
North Carolina,M07,2003,6.8,292664,3993219,4285883
North Carolina,M06,2003,7.0,303057,4004881,4307938
North Carolina,M05,2003,6.4,271603,4002942,4274545
North Carolina,M04,2003,6.3,268476,4001125,4269601
North Carolina,M03,2003,6.3,267971,3975249,4243220
North Carolina,M02,2003,6.7,282810,3949328,4232138
North Carolina,M01,2003,6.9,288078,3906533,4194611
North Carolina,M12,2002,6.5,269770,3874137,4143907
North Carolina,M11,2002,6.5,272086,3888472,4160558
North Carolina,M10,2002,6.0,250147,3933950,4184097
North Carolina,M09,2002,5.9,246329,3938932,4185261
North Carolina,M08,2002,6.4,269226,3921447,4190673
North Carolina,M07,2002,6.8,286393,3933119,4219512
North Carolina,M06,2002,6.9,289180,3918271,4207451
North Carolina,M05,2002,6.6,275894,3925402,4201296
North Carolina,M04,2002,6.8,283978,3907897,4191875
North Carolina,M03,2002,7.0,292070,3897145,4189215
North Carolina,M02,2002,7.1,296844,3894766,4191610
North Carolina,M01,2002,7.4,305801,3845298,4151099
North Carolina,M12,2001,6.5,272964,3903412,4176376
North Carolina,M11,2001,6.5,273947,3918002,4191949
North Carolina,M10,2001,6.0,251181,3947565,4198746
North Carolina,M09,2001,5.6,234342,3950357,4184699
North Carolina,M08,2001,5.8,243505,3935920,4179425
North Carolina,M07,2001,5.6,235200,3997732,4232932
North Carolina,M06,2001,5.4,226247,3986782,4213029
North Carolina,M05,2001,5.0,211210,3991824,4203034
North Carolina,M04,2001,4.8,201602,3993066,4194668
North Carolina,M03,2001,5.1,214694,4004703,4219397
North Carolina,M02,2001,5.0,209858,3990177,4200035
North Carolina,M01,2001,4.9,203732,3982031,4185763
North Carolina,M12,2000,3.9,161462,3999884,4161346
North Carolina,M11,2000,3.9,163766,3991127,4154893
North Carolina,M10,2000,3.7,153358,3996962,4150320
North Carolina,M09,2000,3.5,144757,3983954,4128711
North Carolina,M08,2000,4.0,167534,3992633,4160167
North Carolina,M07,2000,3.8,159085,4014942,4174027
North Carolina,M06,2000,3.7,153339,4019603,4172942
North Carolina,M05,2000,3.5,145443,3990605,4136048
North Carolina,M04,2000,3.0,124042,4002249,4126291
North Carolina,M03,2000,3.5,145194,3974953,4120147
North Carolina,M02,2000,3.8,155617,3945854,4101471
North Carolina,M01,2000,3.7,150873,3921040,4071913
Illinois,M12,2016,5.6,363140,6118331,6481471
Illinois,M11,2016,5.2,340691,6152796,6493487
Illinois,M10,2016,5.6,363282,6156785,6520067
Illinois,M09,2016,5.6,364791,6152231,6517022
Illinois,M08,2016,5.8,380780,6162094,6542874
Illinois,M07,2016,5.9,386828,6220568,6607396
Illinois,M06,2016,6.0,393374,6217193,6610567
Illinois,M05,2016,5.3,342972,6173917,6516889
Illinois,M04,2016,5.8,380480,6156860,6537340
Illinois,M03,2016,6.4,419163,6148918,6568081
Illinois,M02,2016,6.6,434443,6121072,6555515
Illinois,M01,2016,6.7,439742,6077639,6517381
Illinois,M12,2015,6.0,390322,6143552,6533874
Illinois,M11,2015,5.8,379392,6154405,6533797
Illinois,M10,2015,5.6,367218,6155601,6522819
Illinois,M09,2015,5.4,347170,6127962,6475132
Illinois,M08,2015,5.8,375797,6143675,6519472
Illinois,M07,2015,6.2,405709,6189200,6594909
Illinois,M06,2015,6.0,398300,6193048,6591348
Illinois,M05,2015,5.7,373676,6143553,6517229
Illinois,M04,2015,5.5,352732,6108171,6460903
Illinois,M03,2015,6.0,387216,6057693,6444909
Illinois,M02,2015,6.5,417743,6030936,6448679
Illinois,M01,2015,6.9,442150,6002520,6444670
Illinois,M12,2014,5.8,374714,6070273,6444987
Illinois,M11,2014,6.0,389704,6101917,6491621
Illinois,M10,2014,6.1,395703,6115633,6511336
Illinois,M09,2014,6.2,400856,6075266,6476122
Illinois,M08,2014,6.9,446713,6063180,6509893
Illinois,M07,2014,7.3,479310,6116368,6595678
Illinois,M06,2014,7.1,465801,6112915,6578716
Illinois,M05,2014,6.9,445506,6045730,6491236
Illinois,M04,2014,6.8,441328,6019342,6460670
Illinois,M03,2014,8.2,536355,5985726,6522081
Illinois,M02,2014,8.9,581333,5936653,6517986
Illinois,M01,2014,8.9,576267,5909686,6485953
Illinois,M12,2013,8.3,537476,5966362,6503838
Illinois,M11,2013,8.3,544245,5982874,6527119
Illinois,M10,2013,8.7,570321,5950407,6520728
Illinois,M09,2013,8.6,565205,5979397,6544602
Illinois,M08,2013,9.1,598269,5975528,6573797
Illinois,M07,2013,9.4,627740,6028977,6656717
Illinois,M06,2013,9.7,645117,6022180,6667297
Illinois,M05,2013,8.8,577258,5973624,6550882
Illinois,M04,2013,8.6,559942,5946778,6506720
Illinois,M03,2013,9.2,599691,5908290,6507981
Illinois,M02,2013,9.9,647815,5895393,6543208
Illinois,M01,2013,10.4,679826,5877925,6557751
Illinois,M12,2012,9.1,596384,5985419,6581803
Illinois,M11,2012,8.4,548819,6019355,6568174
Illinois,M10,2012,8.6,566372,6049922,6616294
Illinois,M09,2012,8.3,548420,6028489,6576909
Illinois,M08,2012,9.2,607085,5997781,6604866
Illinois,M07,2012,9.6,641233,6047275,6688508
Illinois,M06,2012,9.4,629340,6055216,6684556
Illinois,M05,2012,8.6,566487,6000184,6566671
Illinois,M04,2012,8.3,543290,5970242,6513532
Illinois,M03,2012,9.0,588345,5946423,6534768
Illinois,M02,2012,9.6,625164,5912149,6537313
Illinois,M01,2012,9.7,633734,5875278,6509012
Illinois,M12,2011,9.2,601947,5974494,6576441
Illinois,M11,2011,9.0,594732,5991621,6586353
Illinois,M10,2011,9.6,633683,5984508,6618191
Illinois,M09,2011,9.8,646609,5964691,6611300
Illinois,M08,2011,10.3,682272,5963924,6646196
Illinois,M07,2011,10.4,691164,5985464,6676628
Illinois,M06,2011,10.2,682725,5987822,6670547
Illinois,M05,2011,9.3,612156,5950488,6562644
Illinois,M04,2011,9.1,590912,5937432,6528344
Illinois,M03,2011,9.5,622423,5911307,6533730
Illinois,M02,2011,9.9,646023,5874161,6520184
Illinois,M01,2011,10.1,657676,5854475,6512151
Illinois,M12,2010,9.3,607035,5950119,6557154
Illinois,M11,2010,9.4,620510,5966483,6586993
Illinois,M10,2010,9.3,610061,5974998,6585059
Illinois,M09,2010,9.4,619794,5976043,6595837
Illinois,M08,2010,10.1,673324,5981152,6654476
Illinois,M07,2010,10.6,709384,5998327,6707711
Illinois,M06,2010,10.4,698892,6003452,6702344
Illinois,M05,2010,10.1,667477,5964253,6631730
Illinois,M04,2010,10.5,701396,5956490,6657886
Illinois,M03,2010,11.5,762036,5866020,6628056
Illinois,M02,2010,11.9,787205,5822509,6609714
Illinois,M01,2010,12.2,802173,5784712,6586885
Illinois,M12,2009,11.0,720556,5836511,6557067
Illinois,M11,2009,10.4,681984,5897407,6579391
Illinois,M10,2009,10.6,700108,5885721,6585829
Illinois,M09,2009,10.4,687073,5892913,6579986
Illinois,M08,2009,10.6,705791,5949383,6655174
Illinois,M07,2009,10.9,734276,6025630,6759906
Illinois,M06,2009,10.7,722580,6026461,6749041
Illinois,M05,2009,9.9,659908,5974205,6634113
Illinois,M04,2009,9.6,631093,5976595,6607688
Illinois,M03,2009,9.8,648334,5937360,6585694
Illinois,M02,2009,9.7,636903,5950007,6586910
Illinois,M01,2009,8.8,576541,5966550,6543091
Illinois,M12,2008,7.6,498047,6088252,6586299
Illinois,M11,2008,6.6,432000,6148981,6580981
Illinois,M10,2008,6.4,420973,6192485,6613458
Illinois,M09,2008,6.2,406940,6190319,6597259
Illinois,M08,2008,6.7,446781,6221835,6668616
Illinois,M07,2008,6.6,446487,6306216,6752703
Illinois,M06,2008,6.7,451337,6315684,6767021
Illinois,M05,2008,6.0,397462,6279305,6676767
Illinois,M04,2008,5.2,345407,6305014,6650421
Illinois,M03,2008,5.7,380329,6284153,6664482
Illinois,M02,2008,5.9,394039,6259898,6653937
Illinois,M01,2008,6.0,403592,6271190,6674782
Illinois,M12,2007,5.4,364797,6351796,6716593
Illinois,M11,2007,4.8,325048,6401013,6726061
Illinois,M10,2007,4.8,323538,6378322,6701860
Illinois,M09,2007,4.9,325608,6369311,6694919
Illinois,M08,2007,5.1,339242,6355241,6694483
Illinois,M07,2007,5.3,359740,6416894,6776634
Illinois,M06,2007,5.2,353592,6396568,6750160
Illinois,M05,2007,4.5,299651,6311578,6611229
Illinois,M04,2007,4.6,303135,6278239,6581374
Illinois,M03,2007,4.6,301490,6280025,6581515
Illinois,M02,2007,5.2,339402,6239566,6578968
Illinois,M01,2007,5.2,343853,6229564,6573417
Illinois,M12,2006,4.2,281371,6347110,6628481
Illinois,M11,2006,3.9,258729,6346714,6605443
Illinois,M10,2006,3.6,240168,6349259,6589427
Illinois,M09,2006,4.0,263053,6284127,6547180
Illinois,M08,2006,4.5,299279,6295548,6594827
Illinois,M07,2006,4.8,315053,6310638,6625691
Illinois,M06,2006,4.7,308797,6281291,6590088
Illinois,M05,2006,4.3,278946,6187476,6466422
Illinois,M04,2006,4.6,299159,6147251,6446410
Illinois,M03,2006,4.9,313954,6111826,6425780
Illinois,M02,2006,5.4,344955,6072345,6417300
Illinois,M01,2006,5.4,341667,6036555,6378222
Illinois,M12,2005,5.1,329069,6103111,6432180
Illinois,M11,2005,5.2,335862,6098537,6434399
Illinois,M10,2005,5.1,325409,6105773,6431182
Illinois,M09,2005,5.4,345669,6057623,6403292
Illinois,M08,2005,5.4,346463,6089348,6435811
Illinois,M07,2005,5.8,376475,6108828,6485303
Illinois,M06,2005,6.0,390356,6073168,6463524
Illinois,M05,2005,5.6,357317,6013681,6370998
Illinois,M04,2005,5.7,362833,5988616,6351449
Illinois,M03,2005,6.0,376994,5943412,6320406
Illinois,M02,2005,6.6,418675,5919803,6338478
Illinois,M01,2005,6.4,401612,5905061,6306673
Illinois,M12,2004,5.8,368320,5988239,6356559
Illinois,M11,2004,5.8,369238,5998858,6368096
Illinois,M10,2004,5.8,366009,5979581,6345590
Illinois,M09,2004,5.7,357067,5942204,6299271
Illinois,M08,2004,6.1,385840,5963755,6349595
Illinois,M07,2004,6.3,405793,6006452,6412245
Illinois,M06,2004,6.5,415883,5977097,6392980
Illinois,M05,2004,6.0,374681,5907338,6282019
Illinois,M04,2004,6.0,376476,5886359,6262835
Illinois,M03,2004,6.7,423385,5861950,6285335
Illinois,M02,2004,6.8,424090,5855373,6279463
Illinois,M01,2004,7.0,441052,5830317,6271369
Illinois,M12,2003,6.2,387566,5901802,6289368
Illinois,M11,2003,6.3,397612,5910924,6308536
Illinois,M10,2003,6.3,396094,5898593,6294687
Illinois,M09,2003,6.6,415932,5865007,6280939
Illinois,M08,2003,7.0,444153,5876092,6320245
Illinois,M07,2003,7.1,452261,5918380,6370641
Illinois,M06,2003,7.5,480712,5928255,6408967
Illinois,M05,2003,6.4,401896,5862778,6264674
Illinois,M04,2003,6.3,395468,5865439,6260907
Illinois,M03,2003,6.9,431731,5840871,6272602
Illinois,M02,2003,7.1,448631,5826066,6274697
Illinois,M01,2003,7.3,455300,5801089,6256389
Illinois,M12,2002,6.4,400582,5878357,6278939
Illinois,M11,2002,6.3,396294,5887282,6283576
Illinois,M10,2002,6.1,382728,5931073,6313801
Illinois,M09,2002,5.9,374188,5935826,6310014
Illinois,M08,2002,6.5,412418,5926186,6338604
Illinois,M07,2002,6.9,443303,5964618,6407921
Illinois,M06,2002,7.0,448302,5983957,6432259
Illinois,M05,2002,6.3,397605,5952392,6349997
Illinois,M04,2002,6.5,414583,5940322,6354905
Illinois,M03,2002,6.7,429809,5944221,6374030
Illinois,M02,2002,6.8,438115,5958433,6396548
Illinois,M01,2002,7.0,446171,5904095,6350266
Illinois,M12,2001,6.0,384241,6029302,6413543
Illinois,M11,2001,5.7,362420,6047236,6409656
Illinois,M10,2001,5.3,340154,6081358,6421512
Illinois,M09,2001,5.0,322954,6092641,6415595
Illinois,M08,2001,5.4,350082,6080815,6430897
Illinois,M07,2001,5.2,337199,6186639,6523838
Illinois,M06,2001,5.4,351886,6184098,6535984
Illinois,M05,2001,4.7,303436,6140995,6444431
Illinois,M04,2001,5.0,325549,6133042,6458591
Illinois,M03,2001,5.4,353373,6145088,6498461
Illinois,M02,2001,5.4,351163,6124119,6475282
Illinois,M01,2001,5.4,348479,6118794,6467273
Illinois,M12,2000,4.4,286589,6191515,6478104
Illinois,M11,2000,4.2,269738,6190682,6460420
Illinois,M10,2000,3.8,244235,6204376,6448611
Illinois,M09,2000,4.0,254721,6186461,6441182
Illinois,M08,2000,4.5,290441,6209714,6500155
Illinois,M07,2000,4.5,296245,6250586,6546831
Illinois,M06,2000,4.5,298709,6282664,6581373
Illinois,M05,2000,4.1,266675,6208492,6475167
Illinois,M04,2000,4.0,257230,6239343,6496573
Illinois,M03,2000,4.6,300059,6211063,6511122
Illinois,M02,2000,4.8,313810,6194662,6508472
Illinois,M01,2000,4.7,306286,6167290,6473576
New Jersey,M12,2016,4.2,187578,4303673,4491251
New Jersey,M11,2016,4.2,186915,4305879,4492794
New Jersey,M10,2016,4.6,205724,4299544,4505268
New Jersey,M09,2016,4.9,220483,4279538,4500021
New Jersey,M08,2016,5.0,229302,4315821,4545123
New Jersey,M07,2016,5.5,252733,4338706,4591439
New Jersey,M06,2016,5.2,236030,4334387,4570417
New Jersey,M05,2016,5.0,224726,4299910,4524636
New Jersey,M04,2016,5.1,228488,4294064,4522552
New Jersey,M03,2016,5.4,245237,4294143,4539380
New Jersey,M02,2016,5.3,241938,4281070,4523008
New Jersey,M01,2016,5.2,232767,4252439,4485206
New Jersey,M12,2015,4.5,204122,4306936,4511058
New Jersey,M11,2015,4.7,212993,4295138,4508131
New Jersey,M10,2015,4.9,221189,4285660,4506849
New Jersey,M09,2015,5.2,233932,4245333,4479265
New Jersey,M08,2015,5.5,249063,4288347,4537410
New Jersey,M07,2015,6.2,286734,4304766,4591500
New Jersey,M06,2015,6.0,273636,4305718,4579354
New Jersey,M05,2015,6.1,275748,4275053,4550801
New Jersey,M04,2015,5.9,267843,4257993,4525836
New Jersey,M03,2015,6.6,297600,4234863,4532463
New Jersey,M02,2015,6.9,312365,4217182,4529547
New Jersey,M01,2015,7.0,316476,4197855,4514331
New Jersey,M12,2014,6.1,273954,4252156,4526110
New Jersey,M11,2014,6.2,281281,4249050,4530331
New Jersey,M10,2014,6.3,284236,4249535,4533771
New Jersey,M09,2014,6.5,292735,4209563,4502298
New Jersey,M08,2014,6.8,307552,4237470,4545022
New Jersey,M07,2014,7.2,328770,4258521,4587291
New Jersey,M06,2014,6.5,297984,4256167,4554151
New Jersey,M05,2014,6.5,293501,4211640,4505141
New Jersey,M04,2014,6.3,281567,4193714,4475281
New Jersey,M03,2014,7.4,331879,4167041,4498920
New Jersey,M02,2014,7.7,343160,4137724,4480884
New Jersey,M01,2014,7.5,334738,4115769,4450507
New Jersey,M12,2013,6.7,299424,4161704,4461128
New Jersey,M11,2013,6.9,309187,4159406,4468593
New Jersey,M10,2013,7.6,338028,4132883,4470911
New Jersey,M09,2013,7.8,349806,4139084,4488890
New Jersey,M08,2013,8.0,363427,4183106,4546533
New Jersey,M07,2013,8.6,395906,4204727,4600633
New Jersey,M06,2013,8.6,397352,4206173,4603525
New Jersey,M05,2013,8.4,382266,4170875,4553141
New Jersey,M04,2013,8.2,373406,4160386,4533792
New Jersey,M03,2013,8.7,397029,4144835,4541864
New Jersey,M02,2013,9.2,420513,4135437,4555950
New Jersey,M01,2013,9.7,441475,4115840,4557315
New Jersey,M12,2012,8.9,406001,4176309,4582310
New Jersey,M11,2012,9.0,413892,4172617,4586509
New Jersey,M10,2012,8.9,408120,4185440,4593560
New Jersey,M09,2012,9.0,408942,4155736,4564678
New Jersey,M08,2012,9.4,431355,4169037,4600392
New Jersey,M07,2012,10.0,464248,4188142,4652390
New Jersey,M06,2012,9.6,447801,4200067,4647868
New Jersey,M05,2012,9.3,425279,4161179,4586458
New Jersey,M04,2012,9.2,419112,4145347,4564459
New Jersey,M03,2012,9.5,432931,4141634,4574565
New Jersey,M02,2012,9.7,444627,4124344,4568971
New Jersey,M01,2012,9.6,434250,4099975,4534225
New Jersey,M12,2011,8.9,405508,4162287,4567795
New Jersey,M11,2011,8.8,402088,4164702,4566790
New Jersey,M10,2011,9.0,411455,4158493,4569948
New Jersey,M09,2011,9.2,419465,4133394,4552859
New Jersey,M08,2011,9.2,424019,4168968,4592987
New Jersey,M07,2011,9.7,448175,4171440,4619615
New Jersey,M06,2011,9.5,436072,4162510,4598582
New Jersey,M05,2011,9.2,418503,4136695,4555198
New Jersey,M04,2011,9.1,413747,4131373,4545120
New Jersey,M03,2011,9.7,440651,4113430,4554081
New Jersey,M02,2011,9.9,451609,4089475,4541084
New Jersey,M01,2011,10.0,450403,4068804,4519207
New Jersey,M12,2010,9.1,414262,4128327,4542589
New Jersey,M11,2010,9.2,418187,4120385,4538572
New Jersey,M10,2010,9.0,408332,4120632,4528964
New Jersey,M09,2010,9.2,414609,4108747,4523356
New Jersey,M08,2010,9.3,426591,4157177,4583768
New Jersey,M07,2010,9.8,452614,4166870,4619484
New Jersey,M06,2010,9.3,428868,4165950,4594818
New Jersey,M05,2010,9.2,421839,4138961,4560800
New Jersey,M04,2010,9.4,428981,4140829,4569810
New Jersey,M03,2010,10.1,460851,4087942,4548793
New Jersey,M02,2010,10.3,465656,4068665,4534321
New Jersey,M01,2010,10.3,465710,4052972,4518682
New Jersey,M12,2009,9.5,430107,4095703,4525810
New Jersey,M11,2009,9.3,420968,4112974,4533942
New Jersey,M10,2009,9.4,427145,4099839,4526984
New Jersey,M09,2009,9.5,428629,4090065,4518694
New Jersey,M08,2009,9.3,427069,4155953,4583022
New Jersey,M07,2009,9.7,447210,4186660,4633870
New Jersey,M06,2009,9.3,427294,4188434,4615728
New Jersey,M05,2009,8.8,400221,4154921,4555142
New Jersey,M04,2009,8.5,385687,4161322,4547009
New Jersey,M03,2009,8.8,399216,4135482,4534698
New Jersey,M02,2009,8.6,390680,4139619,4530299
New Jersey,M01,2009,8.0,360677,4141862,4502539
New Jersey,M12,2008,6.6,297197,4226289,4523486
New Jersey,M11,2008,5.8,260027,4248472,4508499
New Jersey,M10,2008,5.5,247607,4265592,4513199
New Jersey,M09,2008,5.4,243011,4245376,4488387
New Jersey,M08,2008,5.4,246726,4291110,4537836
New Jersey,M07,2008,5.6,256813,4318580,4575393
New Jersey,M06,2008,5.1,231250,4313006,4544256
New Jersey,M05,2008,4.9,220774,4266426,4487200
New Jersey,M04,2008,4.5,199812,4270368,4470180
New Jersey,M03,2008,5.0,224857,4253700,4478557
New Jersey,M02,2008,5.1,228870,4236505,4465375
New Jersey,M01,2008,5.1,228655,4232153,4460808
New Jersey,M12,2007,4.3,191870,4277012,4468882
New Jersey,M11,2007,4.0,176794,4284328,4461122
New Jersey,M10,2007,3.9,172296,4261228,4433524
New Jersey,M09,2007,4.1,180229,4236988,4417217
New Jersey,M08,2007,4.1,180898,4274597,4455495
New Jersey,M07,2007,4.7,213099,4298123,4511222
New Jersey,M06,2007,4.2,190224,4289533,4479757
New Jersey,M05,2007,4.1,178929,4234537,4413466
New Jersey,M04,2007,4.2,183160,4220449,4403609
New Jersey,M03,2007,4.4,193844,4227822,4421666
New Jersey,M02,2007,4.7,208234,4211895,4420129
New Jersey,M01,2007,4.8,210201,4205272,4415473
New Jersey,M12,2006,3.9,174282,4286101,4460383
New Jersey,M11,2006,4.1,180644,4270679,4451323
New Jersey,M10,2006,3.9,174728,4265172,4439900
New Jersey,M09,2006,4.5,197892,4220248,4418140
New Jersey,M08,2006,4.7,210588,4274059,4484647
New Jersey,M07,2006,5.3,239097,4281328,4520425
New Jersey,M06,2006,4.8,215984,4271187,4487171
New Jersey,M05,2006,4.8,211601,4215655,4427256
New Jersey,M04,2006,4.9,216355,4204502,4420857
New Jersey,M03,2006,5.1,224716,4199620,4424336
New Jersey,M02,2006,5.4,240072,4182265,4422337
New Jersey,M01,2006,5.2,226772,4167006,4393778
New Jersey,M12,2005,4.6,203218,4222216,4425434
New Jersey,M11,2005,4.7,207693,4215899,4423592
New Jersey,M10,2005,4.3,188110,4225149,4413259
New Jersey,M09,2005,4.5,196645,4191906,4388551
New Jersey,M08,2005,4.2,184983,4253347,4438330
New Jersey,M07,2005,4.7,208811,4260572,4469383
New Jersey,M06,2005,4.3,188469,4239273,4427742
New Jersey,M05,2005,4.0,175553,4189043,4364596
New Jersey,M04,2005,4.0,175983,4173396,4349379
New Jersey,M03,2005,4.8,208148,4138891,4347039
New Jersey,M02,2005,5.1,219316,4121982,4341298
New Jersey,M01,2005,4.7,203276,4107071,4310347
New Jersey,M12,2004,3.9,170719,4168560,4339279
New Jersey,M11,2004,4.0,175367,4164325,4339692
New Jersey,M10,2004,4.2,181546,4148826,4330372
New Jersey,M09,2004,4.4,188179,4116532,4304711
New Jersey,M08,2004,4.5,197297,4174600,4371897
New Jersey,M07,2004,5.2,230867,4191613,4422480
New Jersey,M06,2004,5.0,218796,4172826,4391622
New Jersey,M05,2004,4.7,203022,4125498,4328520
New Jersey,M04,2004,5.0,215219,4119016,4334235
New Jersey,M03,2004,5.6,242557,4104639,4347196
New Jersey,M02,2004,5.7,245418,4098159,4343577
New Jersey,M01,2004,5.9,255101,4081371,4336472
New Jersey,M12,2003,5.0,216118,4131530,4347648
New Jersey,M11,2003,5.2,226264,4119729,4345993
New Jersey,M10,2003,5.4,232841,4106155,4338996
New Jersey,M09,2003,5.7,245594,4067285,4312879
New Jersey,M08,2003,5.7,250426,4115179,4365605
New Jersey,M07,2003,6.4,281773,4126620,4408393
New Jersey,M06,2003,6.2,273248,4120195,4393443
New Jersey,M05,2003,5.8,250230,4079505,4329735
New Jersey,M04,2003,5.7,247875,4081890,4329765
New Jersey,M03,2003,6.2,267402,4065083,4332485
New Jersey,M02,2003,6.3,273941,4061572,4335513
New Jersey,M01,2003,6.4,275900,4049492,4325392
New Jersey,M12,2002,5.6,242224,4097715,4339939
New Jersey,M11,2002,5.7,246454,4086675,4333129
New Jersey,M10,2002,5.5,239700,4101564,4341264
New Jersey,M09,2002,5.5,237828,4090939,4328767
New Jersey,M08,2002,5.6,243582,4122987,4366569
New Jersey,M07,2002,6.1,267648,4126690,4394338
New Jersey,M06,2002,5.9,257716,4125265,4382981
New Jersey,M05,2002,5.6,244357,4091355,4335712
New Jersey,M04,2002,5.7,246943,4081708,4328651
New Jersey,M03,2002,6.1,265316,4082519,4347835
New Jersey,M02,2002,6.0,261910,4086737,4348647
New Jersey,M01,2002,6.0,259079,4047929,4307008
New Jersey,M12,2001,5.0,215345,4117239,4332584
New Jersey,M11,2001,4.8,206784,4110609,4317393
New Jersey,M10,2001,4.5,195041,4115921,4310962
New Jersey,M09,2001,4.3,185491,4084262,4269753
New Jersey,M08,2001,4.4,188430,4113890,4302320
New Jersey,M07,2001,4.4,189854,4154763,4344617
New Jersey,M06,2001,4.1,177523,4139435,4316958
New Jersey,M05,2001,3.7,157313,4097761,4255074
New Jersey,M04,2001,3.6,154734,4094084,4248818
New Jersey,M03,2001,4.0,169433,4092366,4261799
New Jersey,M02,2001,4.1,172863,4083052,4255915
New Jersey,M01,2001,4.2,178398,4071314,4249712
New Jersey,M12,2000,3.3,141006,4140857,4281863
New Jersey,M11,2000,3.5,149826,4114579,4264405
New Jersey,M10,2000,3.4,143785,4105952,4249737
New Jersey,M09,2000,3.6,152147,4083297,4235444
New Jersey,M08,2000,3.8,163227,4142033,4305260
New Jersey,M07,2000,4.1,175714,4158964,4334678
New Jersey,M06,2000,3.5,151534,4169932,4321466
New Jersey,M05,2000,3.5,149107,4117862,4266969
New Jersey,M04,2000,3.3,141498,4133291,4274789
New Jersey,M03,2000,3.9,168785,4122354,4291139
New Jersey,M02,2000,4.3,183852,4107363,4291215
New Jersey,M01,2000,4.2,179743,4088121,4267864
